Archivo,Método,η1,η2,N1,N2,η,N,V,D,E,T,B,CC,refactor
SpelReproTests.java,run,14,203,428,795,217,1223,9492.377157279598,27.413793103448278,260222.0634495614,14456.78130275341,1.3586517614023557,15,0
SpelReproTests.java,from,3,5,3,6,8,9,27.0,1.7999999999999998,48.599999999999994,2.6999999999999997,0.004439181733794845,1,0
SpelReproTests.java,from,3,5,3,6,8,9,27.0,1.7999999999999998,48.599999999999994,2.6999999999999997,0.004439181733794845,1,0
SpelReproTests.java,from,3,5,3,6,8,9,27.0,1.7999999999999998,48.599999999999994,2.6999999999999997,0.004439181733794845,1,0
CacheNamespaceHandler.java,extractCacheManager,3,9,7,14,12,21,75.28421251514428,2.3333333333333335,175.66316253533665,9.75906458529648,0.010455204778755302,1,0
CacheNamespaceHandler.java,parseKeyGenerator,4,19,10,26,23,36,162.84823041805248,2.736842105263158,445.68989377572257,24.76054965420681,0.01944914897283001,2,0
AbstractSockJsIntegrationTests.java,awaitEvent,13,116,131,284,129,415,2909.65931100065,15.913793103448274,46303.7162767862,2572.428682043678,0.4298226632912761,15,0
SpringRunnerContextCacheTests.java,verifyInitialCacheState,1,6,1,6,7,7,19.651484454403228,0.5,9.825742227201614,0.5458745681778674,0.0015291696022456767,1,0
SpringRunnerContextCacheTests.java,verifyFinalCacheState,2,14,13,39,16,52,208.0,2.7857142857142856,579.4285714285714,32.19047619047619,0.02316747392106232,1,0
MetaAnnotationUtils.java,findAnnotationDescriptorForTypes,6,9,13,14,15,27,105.48604608143,4.666666666666667,492.2682150466734,27.348234169259634,0.020781645965528363,5,0
MetaAnnotationUtils.java,findAnnotationDescriptorForTypes,11,23,39,63,34,102,518.9212098075346,15.06521739130435,7817.660834709164,434.3144908171758,0.13129956739615914,7,0
MetaAnnotationUtils.java,assertNonEmptyAnnotationTypeArray,10,47,107,179,57,286,1668.206544051116,19.04255319148936,31766.911849484015,1764.8284360824453,0.33434544472050154,9,0
WebTestClient.java,bindToController,6,10,10,12,16,22,88.0,3.5999999999999996,316.79999999999995,17.599999999999998,0.015490622145572777,1,0
WebTestClient.java,bindToRouterFunction,5,10,10,12,15,22,85.95159310338741,3.0,257.85477931016226,14.325265517231237,0.013503992939902846,1,0
WebTestClient.java,bindToServer,7,134,174,341,141,515,3676.8689464853787,8.906716417910447,32748.82901216641,1819.3793895648005,0.34120018848848827,31,0
TestAnnotationUtils.java,getTimeout,3,12,9,16,15,25,97.67226489021297,2.0,195.34452978042594,10.85247387669033,0.011222240751633781,3,0
TestAnnotationUtils.java,getRepeatCount,3,11,9,15,14,24,91.3765181293825,2.0454545454545454,186.90651435555512,10.383695241975284,0.010896701082134082,2,0
RSocketRequester.java,wrap,6,48,48,119,54,167,961.0662128612992,7.4375,7147.929958155913,397.1072198975507,0.12368933960813214,21,0
SharedEntityManagerCreator.java,createSharedEntityManager,1,6,1,8,7,9,25.26619429851844,0.6666666666666666,16.844129532345626,0.9357849740192015,0.0021903379454711043,2,0
SharedEntityManagerCreator.java,createSharedEntityManager,4,8,5,11,12,16,57.3594000115385,2.75,157.73835003173087,8.763241668429494,0.009731286848828622,2,0
SharedEntityManagerCreator.java,createSharedEntityManager,8,14,20,25,22,45,200.67442283867837,7.142857142857143,1433.3887345619885,79.63270747566602,0.042376140827577305,2,0
SharedEntityManagerCreator.java,createSharedEntityManager,5,10,11,14,15,25,97.67226489021297,3.5,341.8529271157454,18.991829284208077,0.01629689799417688,2,0
SharedEntityManagerCreator.java,createSharedEntityManager,18,115,310,438,133,748,5277.35126175489,34.278260869565216,180898.42325076327,10049.912402820182,1.0661916236976956,52,0
MimeTypeUtils.java,parseMimeType,5,11,8,16,16,24,96.0,3.6363636363636367,349.0909090909091,19.393939393939394,0.016526127717418036,3,0
MimeTypeUtils.java,parseMimeTypeInternal,15,59,145,196,74,341,2117.423597679472,24.915254237288135,52756.147264217354,2930.8970702342976,0.46887901194855447,25,0
MimeTypeUtils.java,toString,9,45,69,116,54,185,1064.6541879002416,11.600000000000001,12349.988579642804,686.1104766468225,0.17809693657393855,9,0
MimeTypeUtils.java,initRandom,4,8,11,18,12,29,103.96391252091352,4.5,467.83760634411084,25.99097813022838,0.020088252774581244,3,0
MimeTypeUtils.java,generateMultipartBoundaryString,3,5,3,6,8,9,27.0,1.7999999999999998,48.599999999999994,2.6999999999999997,0.004439181733794845,1,0
GenericCollectionTypeResolver.java,forMethodParameter,3,6,7,15,9,22,69.73835003173087,3.75,261.51881261899075,14.528822923277264,0.013631616800472117,2,0
DefaultConversionTests.java,valueOf,4,20,21,56,24,77,353.042112555529,5.6,1977.0358303109622,109.83532390616456,0.05250755211458935,1,0
DefaultConversionTests.java,findTestEntity,7,9,14,18,16,32,128.0,7.0,896.0,49.77777777777778,0.030980190579006413,1,0
Response.java,from,7,11,11,17,18,28,116.75790004038474,5.409090909090909,631.5540956729902,35.086338648499456,0.024536867397145865,1,0
Response.java,status,3,7,4,10,10,14,46.50699332842307,2.142857142857143,99.65784284662087,5.5365468248122705,0.007165058383377737,1,0
Response.java,status,2,3,2,5,5,7,16.253496664211536,1.6666666666666667,27.089161107019226,1.5049533948344014,0.0030066008967897778,1,0
Response.java,ok,2,5,2,5,7,7,19.651484454403228,1.0,19.651484454403228,1.0917491363557348,0.00242740543524258,1,0
Response.java,created,3,8,4,12,11,16,55.35090589819676,2.25,124.5395382709427,6.918863237274595,0.00831285578253799,1,0
Response.java,accepted,5,8,7,10,13,17,62.907475208398566,3.125,196.5858600262455,10.92143666812475,0.011269732209158166,1,0
Response.java,badRequest,5,8,7,10,13,17,62.907475208398566,3.125,196.5858600262455,10.92143666812475,0.011269732209158166,1,0
Response.java,unprocessableEntity,5,61,67,144,66,211,1275.3671591846337,5.9016393442622945,7526.757005024067,418.15316694578155,0.12802182351531918,4,0
ShallowEtagHeaderFilter.java,disableContentCaching,1,8,2,10,9,12,38.039100017307746,0.625,23.774437510817343,1.3208020839342969,0.0027560403969563805,1,0
ShallowEtagHeaderFilter.java,isContentCachingDisabled,6,21,17,46,27,63,299.5579126362985,6.571428571428572,1968.5234258956762,109.36241254975978,0.05235672467472227,2,0
TestPropertySourceUtils.java,buildMergedTestPropertySources,9,27,32,50,36,82,423.9338501182696,8.333333333333334,3532.782084318914,196.26567135105077,0.07731966756988255,7,0
TestPropertySourceUtils.java,mergeTestPropertySourceAttributes,6,10,11,27,16,38,152.0,8.100000000000001,1231.2000000000003,68.40000000000002,0.03829109769529691,4,0
TestPropertySourceUtils.java,duplicationDetected,9,33,51,83,42,134,722.5705346523539,11.318181818181818,8178.184687656188,454.3435937586771,0.13530588553161318,12,0
TestPropertySourceUtils.java,addPropertiesFilesToEnvironment,1,8,6,16,9,22,69.73835003173087,1.0,69.73835003173087,3.874352779540604,0.00564754704415116,3,0
TestPropertySourceUtils.java,addPropertiesFilesToEnvironment,2,13,6,17,15,23,89.85848369899593,1.3076923076923077,117.5072479140716,6.528180439670645,0.007996903375658847,5,0
TestPropertySourceUtils.java,addPropertySourcesToEnvironment,3,9,5,17,12,22,78.86917501586544,2.833333333333333,223.46266254495205,12.414592363608447,0.012274827321509906,5,0
TestPropertySourceUtils.java,addPropertySourcesToEnvironment,12,43,40,74,55,114,659.0750073418112,10.325581395348838,6805.3326339480045,378.0740352193336,0.11970482343726174,5,0
TestPropertySourceUtils.java,addInlinedPropertiesToEnvironment,1,8,6,15,9,21,66.56842503028855,0.9375,62.407898465895514,3.4671054703275286,0.005244512410993568,2,0
TestPropertySourceUtils.java,addInlinedPropertiesToEnvironment,15,77,138,195,92,333,2172.3461313669854,18.99350649350649,41260.47035226254,2292.2483529034744,0.3980169141247923,18,0
BeanNamePointcutMatchingTests.java,matches,4,11,7,19,15,26,101.57915548582149,3.4545454545454546,350.9098098601106,19.49498943667281,0.016583483060234536,1,0
UriComponentsBuilder.java,newInstance,2,2,3,3,4,6,12.0,1.5,18.0,1.0,0.0022894284851066636,1,0
UriComponentsBuilder.java,fromPath,4,5,4,11,9,15,47.548875021634686,4.4,209.21505009519262,11.623058338621812,0.011747371246463426,1,0
UriComponentsBuilder.java,fromUri,4,5,4,11,9,15,47.548875021634686,4.4,209.21505009519262,11.623058338621812,0.011747371246463426,4,0
UriComponentsBuilder.java,fromUriString,8,33,54,110,41,164,878.6385287573657,13.333333333333334,11715.180383431543,650.8433546350857,0.1719404524719938,10,0
UriComponentsBuilder.java,fromHttpUrl,13,120,313,591,133,904,6377.975321693076,32.012499999999996,204174.93498569957,11343.051943649976,1.1557938056793688,37,0
HandlerMethodValidator.java,from,9,43,31,72,52,103,587.1452909685324,7.534883720930233,4424.07149473964,245.78174970775777,0.08983112455067215,7,0
MockServerHttpRequest.java,method,2,6,2,9,8,11,33.0,1.5,49.5,2.75,0.00449381867353784,1,0
MockServerHttpRequest.java,method,7,21,26,42,28,68,326.90013469991703,7.0,2288.300942899419,127.12783016107885,0.05788341846251576,1,0
MockServerHttpRequest.java,post,2,9,5,11,11,16,55.35090589819676,1.2222222222222223,67.65110720890715,3.758394844939286,0.005534291340147591,1,0
MockServerHttpRequest.java,put,2,9,5,11,11,16,55.35090589819676,1.2222222222222223,67.65110720890715,3.758394844939286,0.005534291340147591,1,0
MockServerHttpRequest.java,patch,8,86,150,333,94,483,3165.866415360299,15.488372093023257,49034.11703790603,2724.1176132170017,0.4465577711375301,2,0
MethodValidationInterceptor.java,getTarget,11,31,57,73,42,130,701.0012649612389,12.951612903225808,9079.097028449596,504.3942793583109,0.14506874375880158,9,0
TestPropertySourceUtilsTests.java,assertMergedTestPropertySources,7,58,61,146,65,207,1246.63013729689,8.810344827586206,10983.241382046737,610.1800767803743,0.1647020851764003,1,0
TestBeanCreator.java,createTestBean,4,8,5,15,12,20,71.69925001442311,3.75,268.8721875540867,14.937343753004816,0.01388596285022766,1,0
TestBeanCreator.java,createTestBean,4,5,5,10,9,15,47.548875021634686,4.0,190.19550008653874,10.566416671474375,0.011024161587825522,1,0
TestContextAotGeneratorTests.java,assertRuntimeHints,3,58,181,233,61,414,2455.325257751035,6.025862068965518,14795.451337654946,821.969518758608,0.20089273153320808,1,0
TestContextAotGeneratorTests.java,assertReflectionRegistered,1,15,5,20,16,25,100.0,0.6666666666666666,66.66666666666666,3.7037037037037033,0.005480471276289932,2,0
TestContextAotGeneratorTests.java,assertReflectionRegistered,4,14,8,19,18,27,112.58797503894243,2.7142857142857144,305.59593224855803,16.977551791586556,0.015123203333567384,2,0
TestContextAotGeneratorTests.java,assertAnnotationRegistered,9,105,154,259,114,413,2821.983575850038,11.100000000000001,31324.017691935427,1740.2232051075237,0.3312305499513963,2,0
TestContextAotGeneratorTests.java,buildMergedContextConfiguration,6,15,8,19,21,27,118.59257041502654,3.8,450.6517675771008,25.036209309838934,0.019593234266975616,2,0
ScenariosForSpringSecurityExpressionTests.java,hasRole,6,21,12,24,27,36,171.17595007788486,3.4285714285714284,586.8889716956052,32.60494287197807,0.023365910620090014,2,0
HintUtils.java,containsHint,2,8,3,13,10,16,53.150849518197795,1.625,86.37013046707142,4.798340581503968,0.006513100741703149,3,0
TypeDescriptor.java,valueOf,8,12,11,21,20,32,138.3016990363956,7.0,968.1118932547693,53.7839940697094,0.0326208882331678,3,0
TypeDescriptor.java,collection,8,14,14,24,22,38,169.4584015082173,6.857142857142857,1162.0004674849185,64.55558152693992,0.036842544249399034,4,0
TypeDescriptor.java,map,8,13,13,22,21,35,153.73110979725664,6.769230769230769,1040.6413586275833,57.813408812643516,0.03423046510288377,3,0
TypeDescriptor.java,array,4,8,8,15,12,23,82.45413751658658,3.75,309.2030156871997,17.17794531595554,0.015241974332396123,9,0
TypeDescriptor.java,nested,5,7,6,12,12,18,64.5293250129808,4.285714285714286,276.554250055632,15.364125003090667,0.014149213614980826,9,0
TypeDescriptor.java,nested,2,5,2,9,7,11,30.880904142633646,1.8,55.58562745674057,3.0880904142633647,0.00485497599449027,7,0
TypeDescriptor.java,nested,2,5,2,9,7,11,30.880904142633646,1.8,55.58562745674057,3.0880904142633647,0.00485497599449027,2,0
TypeDescriptor.java,forObject,4,7,4,10,11,14,48.432042660922164,2.857142857142857,138.3772647454919,7.687625819193995,0.00891774890421995,1,0
TypeDescriptor.java,nested,6,15,18,30,21,48,210.83123629338053,6.0,1264.9874177602833,70.27707876446019,0.038988472068599817,3,0
TypeDescriptor.java,getRelatedIfResolvable,4,8,7,15,12,22,78.86917501586544,3.75,295.7594063094954,16.4310781283053,0.014796913072860659,2,0
JdbcTestUtils.java,countRowsInTable,3,7,4,9,10,13,43.18506523353571,1.9285714285714288,83.2854829503903,4.626971275021684,0.006357088891597815,2,0
JdbcTestUtils.java,countRowsInTableWhere,4,11,9,19,15,28,109.39293667703852,3.4545454545454546,377.90287215704217,20.994604008724565,0.017423371915013367,2,0
JdbcTestUtils.java,deleteFromTables,4,12,15,22,16,37,148.0,3.6666666666666665,542.6666666666666,30.148148148148145,0.022176900221663777,4,0
JdbcTestUtils.java,deleteFromTableWhere,8,18,23,36,26,59,277.3259433703244,8.0,2218.6075469625953,123.25597483125529,0.05670209029816483,3,0
JdbcTestUtils.java,dropTables,6,38,30,105,44,135,737.0232685160352,8.289473684210526,6109.534989014502,339.41861050080564,0.11139974143965083,14,0
JdbcTestUtils.java,containsSqlScriptDelimiters,2,7,3,11,9,14,44.37895002019237,1.5714285714285714,69.73835003173086,3.874352779540603,0.00564754704415116,1,0
JdbcTestUtils.java,splitSqlScript,3,7,3,12,10,15,49.82892142331043,2.571428571428571,128.13151223136967,7.118417346187204,0.008471936913892742,1,0
Jackson2ObjectMapperBuilderTests.java,getSerializerFactoryConfig,2,7,3,8,9,11,34.86917501586544,1.1428571428571428,39.85048573241764,2.2139158740232023,0.0038889690914361732,1,0
Jackson2ObjectMapperBuilderTests.java,getDeserializerFactoryConfig,13,238,503,925,251,1428,11383.364195041702,25.262605042016805,287573.4337087741,15976.301872709671,1.4522607078559313,3,0
RequestPredicates.java,all,3,4,3,4,7,7,19.651484454403228,1.5,29.47722668160484,1.6376237045336022,0.0031808009523339458,1,0
RequestPredicates.java,method,2,5,2,6,7,8,22.458839376460833,1.2,26.950607251753,1.4972559584307221,0.002996340161479074,1,0
RequestPredicates.java,path,6,14,11,25,20,36,155.58941141594505,5.357142857142858,833.5147040139914,46.30637244522174,0.029522576435458664,1,0
RequestPredicates.java,headers,5,7,5,8,12,13,46.60451250937503,2.8571428571428568,133.15575002678577,7.397541668154765,0.00869197954087424,2,0
RequestPredicates.java,contentType,7,28,30,49,35,79,405.21335833865237,6.125,2481.931819824246,137.885101101347,0.061104328610337585,2,0
RequestPredicates.java,accept,7,33,36,59,40,95,505.5831690142995,6.257575757575758,3163.724981862207,175.76249899234483,0.07183640019195903,5,0
RequestPredicates.java,GET,2,8,3,10,10,13,43.18506523353571,1.25,53.98133154191964,2.9989628634399796,0.004761105524876846,4,0
RequestPredicates.java,HEAD,2,8,3,10,10,13,43.18506523353571,1.25,53.98133154191964,2.9989628634399796,0.004761105524876846,4,0
RequestPredicates.java,POST,2,8,3,10,10,13,43.18506523353571,1.25,53.98133154191964,2.9989628634399796,0.004761105524876846,4,0
RequestPredicates.java,PUT,2,8,3,10,10,13,43.18506523353571,1.25,53.98133154191964,2.9989628634399796,0.004761105524876846,4,0
RequestPredicates.java,PATCH,2,8,3,10,10,13,43.18506523353571,1.25,53.98133154191964,2.9989628634399796,0.004761105524876846,4,0
RequestPredicates.java,DELETE,2,8,3,10,10,13,43.18506523353571,1.25,53.98133154191964,2.9989628634399796,0.004761105524876846,4,0
RequestPredicates.java,OPTIONS,2,8,3,10,10,13,43.18506523353571,1.25,53.98133154191964,2.9989628634399796,0.004761105524876846,4,0
RequestPredicates.java,pathExtension,5,9,7,18,14,25,95.1838730514401,5.0,475.9193652572005,26.43996473651114,0.020318937591070993,3,0
RequestPredicates.java,pathExtension,6,12,11,18,18,29,120.92782504182705,4.5,544.1752126882217,30.23195626045676,0.022217980557845855,1,0
RequestPredicates.java,queryParam,6,11,12,18,17,30,122.62388523751017,4.909090909090909,601.971800256868,33.44287779204822,0.023764545343196174,1,0
RequestPredicates.java,traceMatch,14,119,272,546,133,818,5771.221032239973,32.11764705882353,185358.04021194266,10297.66890066348,1.0836433360944906,5,0
RequestPredicates.java,prefixWithSlash,10,20,29,42,30,71,348.3892322882048,10.5,3658.0869390261505,203.22705216811949,0.07913733611592833,3,0
ExtendedBeanInfoTests.java,setProp1,0,3,0,3,3,3,4.754887502163468,0.0,0.0,0.0,0,1,0
Jaxb2XmlDecoderTests.java,assertStartElement,1,12,6,16,13,22,81.40967379910403,0.6666666666666666,54.27311586606935,3.015173103670519,0.004778246851306007,1,0
Jaxb2XmlDecoderTests.java,assertEndElement,1,12,6,16,13,22,81.40967379910403,0.6666666666666666,54.27311586606935,3.015173103670519,0.004778246851306007,1,0
Jaxb2XmlDecoderTests.java,assertCharacters,12,89,192,330,101,522,3475.586393996437,22.247191011235955,77322.03438329152,4295.668576849529,0.6049891601687721,3,0
SpelDocumentationTests.java,reverseString,3,6,4,8,9,12,38.039100017307746,2.0,76.07820003461549,4.22656666858975,0.0059848356844364944,1,0
CachedIntrospectionResults.java,acceptClassLoader,2,6,2,8,8,10,30.0,1.3333333333333333,40.0,2.2222222222222223,0.003898690317617154,5,0
CachedIntrospectionResults.java,clearClassLoader,11,41,58,112,52,170,969.0747520839856,15.02439024390244,14559.757250822808,808.8754028234894,0.19875352267280816,12,0
CachedIntrospectionResults.java,isClassLoaderAccepted,4,11,6,18,15,24,93.76537429460444,3.272727272727273,306.86849769143276,17.048249871746265,0.015165158372215418,5,0
CachedIntrospectionResults.java,isUnderneathClassLoader,15,72,163,257,87,420,2706.0362682564655,26.770833333333336,72442.84593144913,4024.602551747174,0.5792629444492912,29,0
ParameterizedDependencyInjectionTests.java,clearEmployees,4,24,15,35,28,50,240.36774610288018,2.9166666666666665,701.0725928000671,38.94847737778151,0.026305954923196765,1,0
ParameterizedDependencyInjectionTests.java,verifyNumParameterizedRuns,1,5,2,6,6,8,20.67970000576925,0.6,12.407820003461548,0.6893233335256416,0.001786524878441054,1,0
RSocketServerToClientIntegrationTests.java,setupOnce,3,19,15,25,22,40,178.37726474549189,1.973684210526316,352.0603909450498,19.558910608058323,0.016619713129355455,1,0
RSocketServerToClientIntegrationTests.java,tearDownOnce,1,9,1,15,10,16,53.150849518197795,0.8333333333333334,44.292374598498164,2.4606874776943424,0.004172836688275891,1,0
RSocketServerToClientIntegrationTests.java,connectAndRunTest,11,105,186,287,116,473,3243.8250106953415,15.033333333333333,48765.50266078663,2709.194592265924,0.4449254162173314,2,0
AnnotationUtils.java,isInterfaceWithAnnotatedMethods,13,57,140,226,70,366,2243.3175842018577,25.771929824561404,57814.623354254894,3211.9235196808277,0.49839140687994365,51,0
AnnotationUtils.java,isAnnotationDeclaredLocally,7,16,15,28,23,43,194.51316411045156,6.125,1191.3931301765158,66.18850723202866,0.03746123920915172,10,0
AnnotationUtils.java,isAnnotationInherited,7,10,12,19,17,31,126.71134807876051,6.6499999999999995,842.6304647237573,46.812803595764294,0.02973743572867982,4,0
AnnotationUtils.java,isAnnotationMetaPresent,8,19,21,40,27,61,290.04813763197154,8.421052631578947,2442.5106326902865,135.69503514946035,0.060455579329567,5,0
AnnotationUtils.java,isInJavaLangAnnotationPackage,2,7,4,10,9,14,44.37895002019237,1.4285714285714286,63.39850002884624,3.522138890491458,0.005299864104346932,3,0
AnnotationUtils.java,isInJavaLangAnnotationPackage,4,14,9,28,18,37,154.28722505336555,4.0,617.1489002134622,34.28605001185901,0.02416232481193686,9,0
AnnotationUtils.java,getAnnotationAttributes,1,7,1,11,8,12,36.0,0.7857142857142857,28.285714285714285,1.5714285714285714,0.003094497803609548,3,0
AnnotationUtils.java,getAnnotationAttributes,1,7,1,11,8,12,36.0,0.7857142857142857,28.285714285714285,1.5714285714285714,0.003094497803609548,5,0
AnnotationUtils.java,getAnnotationAttributes,1,9,1,14,10,15,49.82892142331043,0.7777777777777778,38.755827773685894,2.1531015429825495,0.0038174212801003293,7,0
AnnotationUtils.java,getAnnotationAttributes,15,38,29,71,53,100,572.7920454563199,14.013157894736842,8026.625373828693,445.92363187937184,0.13362900696292265,13,0
AnnotationUtils.java,adaptValue,9,23,43,81,32,124,620.0,15.847826086956522,9825.652173913044,545.8695652173914,0.15291602589676737,11,0
AnnotationUtils.java,getValue,1,5,1,7,6,8,20.67970000576925,0.7,14.475790004038473,0.8042105557799152,0.00197988634999937,2,0
AnnotationUtils.java,getValue,7,18,15,27,25,42,195.04195997053841,5.25,1023.9702898453266,56.887238324740366,0.03386390074533764,4,0
AnnotationUtils.java,getDefaultValue,1,5,1,7,6,8,20.67970000576925,0.7,14.475790004038473,0.8042105557799152,0.00197988634999937,2,0
AnnotationUtils.java,getDefaultValue,3,8,5,13,11,18,62.26976913547135,2.4375,151.78256226771143,8.432364570428412,0.009484766970379284,4,0
AnnotationUtils.java,getDefaultValue,4,7,4,9,11,13,44.97261104228487,2.5714285714285716,115.64385696587539,6.42465872032641,0.007912136854124296,3,0
AnnotationUtils.java,getDefaultValue,14,63,151,259,77,410,2569.3824816849096,28.777777777777775,73941.1180840435,4107.839893557972,0.5872225899904002,46,0
AnnotationUtils.java,isSynthesizable,9,55,118,189,64,307,1842.0,15.463636363636365,28484.018181818185,1582.4454545454546,0.31089441106715127,34,0
AnnotationUtils.java,getAnnotation,2,12,6,17,14,23,87.56916320732489,1.4166666666666667,124.05631454371027,6.8920174746505705,0.00829133880677079,5,0
AnnotationUtils.java,isAttributeMethod,5,7,11,10,12,21,75.28421251514428,3.5714285714285716,268.87218755408674,14.937343753004818,0.013885962850227664,3,0
AnnotationUtils.java,isAnnotationTypeMethod,5,8,10,11,13,21,77.70923408096293,3.4375,267.12549215331006,14.840305119628336,0.013825758570275615,5,0
AnnotationUtils.java,postProcessAnnotationAttributes,13,44,64,140,57,204,1189.9095628896073,20.68181818181818,24609.493232489604,1367.1940684716446,0.2820204009617872,14,0
AnnotationUtils.java,rethrowAnnotationConfigurationException,2,4,3,8,6,11,28.43458750793272,2.0,56.86917501586544,3.159398611992524,0.004929429926574472,2,0
AnnotationUtils.java,handleIntrospectionFailure,16,79,156,283,95,439,2884.166612057286,28.658227848101266,82655.10392022399,4591.950217790221,0.6324970866520716,20,0
AnnotationUtils.java,from,17,66,221,339,83,560,3570.0220815542775,43.659090909090914,155863.91860604018,8659.106589224455,0.9654041004309168,25,0
AnnotationUtils.java,getAliasedAttributeName,9,18,29,54,27,83,394.65566267956785,13.5,5327.851446174166,295.9917470096759,0.10168264078478897,3,0
StompBrokerRelayMessageHandlerIntegrationTests.java,error,3,6,3,8,9,11,34.86917501586544,2.0,69.73835003173087,3.874352779540604,0.00564754704415116,1,0
StompBrokerRelayMessageHandlerIntegrationTests.java,connect,7,22,19,33,29,52,252.61501174663374,5.25,1326.228811669827,73.67937842610151,0.040236888012136166,1,0
StompBrokerRelayMessageHandlerIntegrationTests.java,connectWithError,7,20,17,29,27,46,218.72482509951953,5.075,1110.0284873800617,61.66824929889232,0.03573563428456766,1,0
StompBrokerRelayMessageHandlerIntegrationTests.java,subscribeWithReceipt,7,27,21,47,34,68,345.9474732050231,6.092592592592593,2107.717012675048,117.09538959305821,0.05479660003052577,1,0
StompBrokerRelayMessageHandlerIntegrationTests.java,send,14,91,183,358,105,541,3632.4068250573723,27.538461538461537,100030.89564388763,5557.27198021598,0.7182928060549384,7,0
DefaultRequestPath.java,initContextPath,11,30,52,66,41,118,632.1911365449339,12.100000000000001,7649.512752193701,424.9729306774278,0.1294100268323807,5,0
DefaultRequestPath.java,extractPathWithinApplication,10,27,66,96,37,162,843.9314452318899,17.77777777777778,15003.225693011378,833.5125385006321,0.20276913113150072,3,0
DomUtils.java,getChildElementByTagName,7,17,15,34,24,49,224.66316253533665,7.0,1572.6421377473566,87.36900765263093,0.04507807384471749,5,0
DomUtils.java,getChildElementValueByTagName,10,24,25,50,34,75,381.55971309377543,10.416666666666668,3974.5803447268277,220.81001915149042,0.08363850581366927,3,0
DomUtils.java,getTextValue,10,21,22,36,31,58,287.34338600243876,8.571428571428571,2462.943308592332,136.8301838106851,0.06079226933283937,4,0
DomUtils.java,nodeNameEquals,2,8,3,14,10,17,56.47277761308516,1.75,98.82736082289902,5.490408934605501,0.007125197011762071,1,0
DomUtils.java,createContentHandler,2,5,2,6,7,8,22.458839376460833,1.2,26.950607251753,1.4972559584307221,0.002996340161479074,1,0
DomUtils.java,nodeNameMatch,3,8,6,13,11,19,65.72920075410865,2.4375,160.21492683813983,8.900829268785547,0.009832879775020063,1,0
DomUtils.java,nodeNameMatch,3,8,6,13,11,19,65.72920075410865,2.4375,160.21492683813983,8.900829268785547,0.009832879775020063,1,0
HttpStatusCode.java,valueOf,10,10,16,18,20,34,146.94555522617034,9.0,1322.5099970355332,73.47277761308517,0.04016163526339613,2,0
ContentDispositionTests.java,parse,7,31,68,129,38,197,1033.8417201483862,14.564516129032258,15057.404407967626,836.5224671093125,0.20325698931685118,1,0
HttpServerErrorException.java,create,1,14,1,20,15,21,82.0447025077789,0.7142857142857143,58.60335893412778,3.255742163007099,0.005029140297137887,1,0
HttpServerErrorException.java,create,5,29,50,318,34,368,1872.1863255801247,27.413793103448274,51323.728580558585,2851.318254475477,0.4603528947036327,12,0
FormTagTests.java,assertFormTagOpened,1,5,1,6,6,7,18.094737505048094,0.6,10.856842503028856,0.6031579168349365,0.001634360172194361,1,0
FormTagTests.java,assertFormTagClosed,1,5,1,6,6,7,18.094737505048094,0.6,10.856842503028856,0.6031579168349365,0.001634360172194361,1,0
HttpStatus.java,valueOf,6,15,12,28,21,40,175.69269691115042,5.6,983.8791027024423,54.659950150135685,0.032974121678374255,4,0
HttpStatus.java,valueOf,7,9,11,16,16,27,108.0,6.222222222222221,671.9999999999999,37.33333333333333,0.02557358386219247,4,0
DefaultRSocketRequesterBuilder.java,isCoreCodec,2,7,6,9,9,15,47.548875021634686,1.2857142857142858,61.13426788495889,3.396348215831049,0.005172913572332008,1,0
DefaultRSocketRequesterBuilder.java,getMimeType,15,93,132,212,108,344,2323.681300744233,17.096774193548388,39727.45449659495,2207.0808053663864,0.38809606368559485,7,0
PathMatchingUrlHandlerMappingTests.java,initConfig,7,51,245,600,58,845,4949.993940882799,41.1764705882353,203823.27991870348,11323.515551039083,1.1544663247198617,5,0
MockHttpServletRequestBuilder.java,addToMap,3,17,12,42,20,54,233.38411712391758,3.7058823529411766,864.8940811062828,48.049671172571266,0.03025896218661758,2,0
SerializableTypeWrapper.java,forField,2,7,2,8,9,10,31.69925001442312,1.1428571428571428,36.22771430219785,2.0126507945665475,0.003649550420649069,1,0
SerializableTypeWrapper.java,forMethodParameter,9,17,12,31,26,43,202.11890788006696,8.205882352941176,1658.5639793687847,92.14244329826582,0.0467053787261689,2,0
SerializableTypeWrapper.java,forTypeProvider,17,99,239,435,116,674,4622.2791907159835,37.348484848484844,172635.1243199227,9590.840239995705,1.0334707430744456,29,0
ControllerAdviceBean.java,createBeanTypePredicate,2,14,11,19,16,30,120.0,1.3571428571428572,162.85714285714286,9.047619047619047,0.009940692035811561,1,0
EndpointHandshakeHandler.java,createRequestUpgradeStrategy,11,36,25,48,47,73,405.48498617246753,7.333333333333333,2973.556565264762,165.19758695915345,0.06892808532319919,3,0
ConcreteTransactionalJUnit38SpringContextTests.java,clearPersonTable,2,5,2,6,7,8,22.458839376460833,1.2,26.950607251753,1.4972559584307221,0.002996340161479074,1,0
ConcreteTransactionalJUnit38SpringContextTests.java,createPersonTable,3,6,3,7,9,10,31.69925001442312,1.75,55.473687525240464,3.0818715291800256,0.004848455744845627,2,0
ConcreteTransactionalJUnit38SpringContextTests.java,countRowsInPersonTable,2,5,2,6,7,8,22.458839376460833,1.2,26.950607251753,1.4972559584307221,0.002996340161479074,1,0
ConcreteTransactionalJUnit38SpringContextTests.java,addPerson,2,6,2,8,8,10,30.0,1.3333333333333333,40.0,2.2222222222222223,0.003898690317617154,1,0
ConcreteTransactionalJUnit38SpringContextTests.java,deletePerson,9,70,51,173,79,224,1412.046887591671,11.121428571428572,15703.9785998588,872.443255547711,0.20903477523808464,1,0
AnnotationConfigUtils.java,registerAnnotationConfigProcessors,14,46,82,131,60,213,1258.1676968646145,19.934782608695652,25081.29952227938,1393.405529015521,0.28561352439167337,14,0
AnnotationConfigUtils.java,registerPostProcessor,4,12,8,19,16,27,108.0,3.1666666666666665,342.0,19.0,0.016301571855893923,1,0
AnnotationConfigUtils.java,unwrapDefaultListableBeanFactory,4,7,12,14,11,26,89.94522208456974,4.0,359.78088833827894,19.987827129904385,0.016861807947340948,3,0
AnnotationConfigUtils.java,processCommonDefinitionAnnotations,1,4,1,7,5,8,18.575424759098897,0.875,16.253496664211536,0.9029720369006409,0.002138831719813076,1,0
AnnotationConfigUtils.java,processCommonDefinitionAnnotations,3,27,39,71,30,110,539.757965516937,3.9444444444444446,2129.0453084279184,118.28029491266213,0.0551656425619921,8,0
AnnotationConfigUtils.java,applyScopedProxyMode,4,16,13,27,20,40,172.8771237954945,3.375,583.4602928097939,32.41446071165522,0.02327481739496877,2,0
AnnotationConfigUtils.java,attributesFor,5,7,5,10,12,15,53.77443751081734,3.5714285714285716,192.0515625386334,10.6695312521463,0.011095766493359117,1,0
AnnotationConfigUtils.java,attributesFor,9,30,37,75,39,112,591.9650485125719,11.25,6659.606795766434,369.9781553203574,0.11798980149748077,3,0
AnnotationConfigUtils.java,addAttributesIfNotNull,4,11,7,15,15,22,85.95159310338741,2.727272727272727,234.4134357365111,13.022968652028394,0.01267263944647716,2,0
BeanWrapperAutoGrowingTests.java,assertNotNull,5,42,55,135,47,190,1055.371881818751,8.035714285714286,8480.666907472107,471.14816152622814,0.13862197513705285,1,0
AotIntegrationTests.java,runTestsInAotMode,4,4,6,6,8,12,36.0,3.0,108.0,6.0,0.007559526299369237,1,0
AotIntegrationTests.java,runTestsInAotMode,10,44,43,64,54,107,615.7729627314911,7.272727272727273,4478.34881986539,248.79715665918835,0.09056436725822775,4,0
AotIntegrationTests.java,createTestClassScanner,6,15,11,21,21,32,140.55415752892034,4.199999999999999,590.3274616214653,32.795970090081404,0.023457086523850004,1,0
DefaultServerWebExchange.java,getContentType,15,147,237,478,162,715,5247.992752062506,24.387755102040817,127986.7620145856,7110.375667476978,0.8465555211769096,35,0
HandlerMappingIntrospector.java,getCorsConfiguration,14,81,114,262,95,376,2470.2657087324365,22.641975308641975,55931.6951829048,3107.3163990502667,0.4875106041200613,11,0
ContextLoaderUtils.java,convertContextConfigToConfigAttributesAndAddToList,7,16,15,30,23,45,203.5602880225656,6.5625,1335.8643901480868,74.21468834156038,0.04043154408038351,4,0
BodyExtractors.java,unsupportedError,9,60,105,168,69,273,1667.6271767004403,12.6,21012.102426425547,1167.339023690308,0.25381955871740786,3,0
BodyExtractors.java,isExtractingForClient,10,25,23,34,35,57,292.36913196586306,6.800000000000001,1988.110097367869,110.45056096488162,0.052703448461070126,1,0
BodyPopulators.java,sseMessageWriter,8,49,77,113,57,190,1108.2491026913008,9.224489795918368,10223.032539111591,567.9462521728661,0.15701166078733597,1,0
RequestContextHolderTests.java,assertRequestAttributes,2,24,7,46,26,53,249.12330506147785,1.9166666666666667,477.4863347011659,26.527018594509215,0.020363513360818642,1,0
ConfigurationClassMethodVisitor.java,initReturnTypeFromMethodDescriptor,5,25,18,38,30,56,274.78587335407707,3.8,1044.1863187454928,58.01035104141627,0.034308158756206276,1,0
RestClient.java,create,3,4,3,4,7,7,19.651484454403228,1.5,29.47722668160484,1.6376237045336022,0.0031808009523339458,2,0
RestClient.java,create,3,6,4,8,9,12,38.039100017307746,2.0,76.07820003461549,4.22656666858975,0.0059848356844364944,2,0
RestClient.java,create,3,6,4,8,9,12,38.039100017307746,2.0,76.07820003461549,4.22656666858975,0.0059848356844364944,1,0
RestClient.java,create,8,130,162,383,138,545,3874.145828944102,11.784615384615385,45655.31853801819,2536.4065854454548,0.42580065982087234,68,0
DefaultResponses.java,serverSentEventHttpMessageWriter,8,43,46,66,51,112,635.3116383008074,6.1395348837209305,3900.5179653817017,216.69544252120565,0.08259623799393745,1,0
DefaultResponses.java,configuration,9,52,87,153,61,240,1423.3769610150928,13.240384615384617,18846.058416517142,1047.0032453620634,0.23606182875376588,2,0
DefaultServerRequestObservationConvention.java,forStatus,3,14,9,18,17,27,110.36149671375915,1.9285714285714288,212.84002937653554,11.824446076474196,0.011882676816786375,3,0
MockClientHttpResponse.java,dumpString,6,20,17,39,26,56,263.22462421590114,5.85,1539.8640516630217,85.54800287016786,0.04444951216179343,2,0
DispatcherApp.java,main,8,76,79,177,84,256,1636.4332602313627,9.31578947368421,15244.667740050063,846.9259855583368,0.2049387364042207,1,0
HttpHeaders.java,readOnlyHttpHeaders,2,4,2,7,6,9,23.264662506490403,1.75,40.71315938635821,2.2618421881310113,0.003944893492189711,1,0
SockJsFrame.java,openFrame,1,2,1,3,3,4,6.339850002884624,0.75,4.754887502163468,0.26416041678685936,0.0009425525573729414,1,0
SockJsFrame.java,heartbeatFrame,1,2,1,3,3,4,6.339850002884624,0.75,4.754887502163468,0.26416041678685936,0.0009425525573729414,1,0
SockJsFrame.java,messageFrame,4,8,7,13,12,20,71.69925001442311,3.25,233.02256254687512,12.94569791927084,0.012622461688364471,1,0
SockJsFrame.java,closeFrameGoAway,1,3,1,3,4,4,8.0,0.5,4.0,0.2222222222222222,0.0008399473665965822,1,0
SockJsFrame.java,closeFrameAnotherConnectionOpen,1,3,1,3,4,4,8.0,0.5,4.0,0.2222222222222222,0.0008399473665965822,1,0
SockJsFrame.java,closeFrame,8,34,45,95,42,140,754.9244391890265,11.176470588235293,8437.390790936179,468.7439328297877,0.13814998910864712,4,0
ViewResolutionResultHandler.java,isFragmentCollection,17,222,448,790,239,1238,9781.273108280167,30.24774774774775,295861.4816310871,16436.74897950484,1.4800317445380973,34,0
CachedExpressionEvaluatorTests.java,mockSpelExpressionParser,3,4,3,7,7,10,28.07354922057604,2.625,73.69306670401211,4.0940592613340065,0.005859085449651798,1,0
HttpRange.java,createByteRange,2,6,2,7,8,9,27.0,1.1666666666666667,31.500000000000004,1.7500000000000002,0.0033246998805754875,1,0
HttpRange.java,createByteRange,2,6,2,9,8,11,33.0,1.5,49.5,2.75,0.00449381867353784,2,0
HttpRange.java,createSuffixRange,9,25,28,45,34,73,371.3847874112748,8.1,3008.2167780313257,167.12315433507365,0.06946267406057599,5,0
HttpRange.java,parseRange,10,33,54,77,43,131,710.8406828659748,11.666666666666668,8293.14130010304,460.73007222794666,0.13657088445267127,8,0
HttpRange.java,toString,14,44,111,204,58,315,1845.2640134651851,32.45454545454545,59887.20480064282,3327.0669333690457,0.510232487299525,13,0
SpelCompilationCoverageTests.java,concat,2,4,2,8,6,10,25.84962500721156,2.0,51.69925001442312,2.87218055635684,0.004625956812489424,1,0
SpelCompilationCoverageTests.java,join,11,302,4196,10330,313,14526,120420.81377054322,188.1291390728477,22654664.02110402,1258592.44561689,26.688069655805982,34,0
SpelCompilationCoverageTests.java,assertIsCompiled,15,212,302,650,227,952,7450.874159900951,22.995283018867923,171334.96004489213,9518.608891382895,1.0282752997043736,15,0
SpelCompilationCoverageTests.java,two,2,6,3,6,8,9,27.0,1.0,27.0,1.5,0.002999999999999999,1,0
SpelCompilationCoverageTests.java,five,1,2,1,2,3,3,4.754887502163468,0.5,2.377443751081734,0.13208020839342968,0.000593770903833207,1,0
SpelCompilationCoverageTests.java,six,3,12,6,19,15,25,97.67226489021297,2.375,231.97162911425582,12.887312728569768,0.012584481508721105,1,0
SpelCompilationCoverageTests.java,eight,1,6,2,9,7,11,30.880904142633646,0.75,23.160678106975233,1.286704339276402,0.0027084007521414465,1,0
SpelCompilationCoverageTests.java,ten,5,46,143,200,51,343,1945.6418922962227,10.869565217391305,21148.28143800242,1174.9045243334679,0.25491504382815616,29,0
SpelCompilationCoverageTests.java,getPlum,4,9,7,16,13,23,85.11011351724513,3.5555555555555554,302.6137369502049,16.811874275011384,0.015024654860565907,1,0
SpelCompilationCoverageTests.java,reset,4,32,57,150,36,207,1070.1744752985587,9.375,10032.885705923987,557.3825392179992,0.1550586464207742,5,0
SpelCompilationCoverageTests.java,getOne,4,10,6,17,14,23,87.56916320732489,3.4,297.7351549049046,16.540841939161368,0.014862738033590492,1,0
SpelCompilationCoverageTests.java,compare,2,4,2,5,6,7,18.094737505048094,1.25,22.61842188131012,1.2565789934061178,0.0026659598967245317,1,0
SpelCompilationCoverageTests.java,compare2,2,5,2,6,7,8,22.458839376460833,1.2,26.950607251753,1.4972559584307221,0.002996340161479074,1,0
SpelCompilationCoverageTests.java,negate,2,2,2,3,4,5,10.0,1.5,15.0,0.8333333333333334,0.002027400665191133,1,0
SpelCompilationCoverageTests.java,append,4,7,8,15,11,23,79.56692722865783,4.285714285714286,341.00111669424786,18.944506483013768,0.016269814926470103,2,0
SpelCompilationCoverageTests.java,append2,4,9,9,16,13,25,92.5109929535273,3.5555555555555554,328.92797494587484,18.273776385881934,0.01588349069041437,2,0
SpelCompilationCoverageTests.java,append3,4,8,5,15,12,20,71.69925001442311,3.75,268.8721875540867,14.937343753004816,0.01388596285022766,2,0
SpelCompilationCoverageTests.java,append4,4,9,10,21,13,31,114.71363126237385,4.666666666666667,535.3302792244114,29.740571068022852,0.021976572036431694,2,0
SpelCompilationCoverageTests.java,appendChar,4,8,8,13,12,21,75.28421251514428,3.25,244.6736906742189,13.592982815234384,0.013039779888936544,2,0
SpelCompilationCoverageTests.java,sum,4,4,7,8,8,15,45.0,4.0,180.0,10.0,0.01062658569182611,2,0
SpelCompilationCoverageTests.java,sumDouble,4,4,7,8,8,15,45.0,4.0,180.0,10.0,0.01062658569182611,2,0
SpelCompilationCoverageTests.java,sumFloat,4,5,7,9,9,16,50.718800023076994,3.6,182.58768008307717,10.143760004615398,0.01072818841743936,2,0
SpelCompilationCoverageTests.java,format,4,9,9,19,13,28,103.61231210795059,4.222222222222222,437.4742066780136,24.304122593222978,0.019209396171600314,1,0
SpelCompilationCoverageTests.java,methoda,1,3,1,3,4,4,8.0,0.5,4.0,0.2222222222222222,0.0008399473665965822,1,0
SpelCompilationCoverageTests.java,methodb,1,2,1,2,3,3,4.754887502163468,0.5,2.377443751081734,0.13208020839342968,0.000593770903833207,1,0
SpelCompilationCoverageTests.java,getPropertya,1,3,1,3,4,4,8.0,0.5,4.0,0.2222222222222222,0.0008399473665965822,1,0
SpelCompilationCoverageTests.java,getPropertyb,9,59,94,197,68,291,1771.4516868038486,15.025423728813559,26616.81220934935,1478.7117894082974,0.2971548153235103,9,0
ExchangeStrategies.java,withDefaults,2,4,2,4,6,6,15.509775004326936,1.0,15.509775004326936,0.861654166907052,0.0020730784816858556,2,0
ExchangeStrategies.java,builder,4,4,4,8,8,12,36.0,4.0,144.0,8.0,0.009157713940426653,2,0
ExchangeStrategies.java,empty,5,13,8,19,18,27,112.58797503894243,3.6538461538461537,411.3791395653666,22.854396642520367,0.018437707555971548,2,0
ControllerMethodResolver.java,customResolvers,7,17,28,46,24,74,339.28722505336555,9.470588235294118,3213.2496019759915,178.51386677644396,0.07258413744119904,1,0
ReflectionUtils.java,findField,4,7,4,10,11,14,48.432042660922164,2.857142857142857,138.3772647454919,7.687625819193995,0.00891774890421995,4,0
ReflectionUtils.java,findField,10,20,37,49,30,86,421.99259122233263,12.25,5169.4092424735745,287.18940235964305,0.09965658984232977,5,0
ReflectionUtils.java,setField,6,14,11,21,20,32,138.3016990363956,4.5,622.3576456637802,34.5754247590989,0.024298087859647315,3,0
ReflectionUtils.java,getField,7,13,12,19,20,31,133.97977094150824,5.115384615384615,685.3580590469459,38.075447724830326,0.02591137310692985,4,0
ReflectionUtils.java,findMethod,5,6,5,10,11,15,51.89147427955946,4.166666666666667,216.2144761648311,12.011915342490617,0.0120079422476533,3,0
ReflectionUtils.java,findMethod,9,21,33,46,30,79,387.64435705307295,9.857142857142858,3821.065805237434,212.28143362430188,0.08147075793556545,5,0
ReflectionUtils.java,invokeMethod,2,5,2,10,7,12,33.68825906469125,2.0,67.3765181293825,3.743139896076806,0.005519305767765066,2,0
ReflectionUtils.java,invokeMethod,7,18,27,58,25,85,394.72777613085157,11.277777777777779,4451.65214192016,247.31400788445333,0.0902040891893992,11,0
ReflectionUtils.java,handleReflectionException,5,11,13,24,16,37,148.0,5.454545454545454,807.2727272727273,44.848484848484844,0.028899628878372316,7,0
ReflectionUtils.java,handleInvocationTargetException,2,6,2,7,8,9,27.0,1.1666666666666667,31.500000000000004,1.7500000000000002,0.0033246998805754875,3,0
ReflectionUtils.java,rethrowRuntimeException,2,8,11,30,10,41,136.19905189038184,3.75,510.7464445889319,28.374802477162884,0.02129849812521389,8,0
ReflectionUtils.java,handleUnexpectedException,2,4,2,5,6,7,18.094737505048094,1.25,22.61842188131012,1.2565789934061178,0.0026659598967245317,3,0
ReflectionUtils.java,declaresException,6,13,15,20,19,35,148.67746297052548,4.615384615384616,686.2036752485792,38.12242640269884,0.025932682234641707,3,0
ReflectionUtils.java,isPublicStaticFinal,4,9,8,15,13,23,85.11011351724513,3.3333333333333335,283.7003783908171,15.761132132823171,0.014391918422636624,1,0
ReflectionUtils.java,isEqualsMethod,9,12,20,17,21,37,162.51574464281416,6.375,1036.0378720979402,57.557659560996676,0.03412944029193606,2,0
ReflectionUtils.java,isHashCodeMethod,5,8,10,11,13,21,77.70923408096293,3.4375,267.12549215331006,14.840305119628336,0.013825758570275615,1,0
ReflectionUtils.java,isToStringMethod,5,8,10,11,13,21,77.70923408096293,3.4375,267.12549215331006,14.840305119628336,0.013825758570275615,1,0
ReflectionUtils.java,isObjectMethod,4,12,10,16,16,26,104.0,2.6666666666666665,277.3333333333333,15.407407407407407,0.01417577439885293,5,0
ReflectionUtils.java,makeAccessible,4,11,15,21,15,36,140.64806144190666,3.8181818181818183,537.0198709600073,29.834437275555963,0.022022788899939773,4,0
ReflectionUtils.java,makeAccessible,4,10,12,17,14,29,110.41329273967052,3.4,375.4051953148798,20.855844184159988,0.017346516132959938,4,0
ReflectionUtils.java,makeAccessible,15,67,149,258,82,407,2587.52366587956,28.880597014925375,74729.22826085,4151.6237922694445,0.5913878668471861,22,0
MessageHeaders.java,getIdGenerator,16,76,121,203,92,324,2113.6340737624723,21.36842105263158,45165.02283934546,2509.1679355191923,0.42274670836870587,7,0
VersionRequestConditionTests.java,initVersionStrategy,9,71,92,229,80,321,2029.3389184588434,14.514084507042254,29453.996555941383,1636.3331419967435,0.3179129603009018,4,0
CommonAnnotationBeanPostProcessorTests.java,create,1,3,1,3,4,4,8.0,0.5,4.0,0.2222222222222222,0.0008399473665965822,1,0
UndertowServerHttpRequest.java,initUri,7,16,14,26,23,40,180.94247824228052,5.6875,1029.1103450029705,57.17279694460947,0.03397713125538853,2,0
UndertowServerHttpRequest.java,initHeaders,11,84,108,202,95,310,2036.655238582594,13.226190476190476,26937.190119824547,1496.5105622124747,0.2995345610537784,8,0
OptionTagTests.java,fromId,8,33,27,79,41,106,567.9005124895169,9.575757575757576,5438.077634748101,302.1154241526723,0.10308030166434692,2,0
MissingFieldException.java,getMessage,7,11,19,19,18,38,158.45715005480787,6.045454545454546,957.9454980586113,53.21919433658952,0.0323921130240093,2,0
AbstractPropertyAccessorTests.java,setProp1,9,38,52,112,47,164,910.9525716751326,13.26315789473684,12082.107792743864,671.2282107079924,0.17551216199353864,2,0
ServerResponse.java,from,4,10,7,16,14,23,87.56916320732489,3.2,280.2213222634397,15.56785123685776,0.014274016593709563,1,0
ServerResponse.java,status,3,6,3,9,9,12,38.039100017307746,2.25,85.58797503894243,4.754887502163468,0.006473720020679235,1,0
ServerResponse.java,ok,2,5,2,5,7,7,19.651484454403228,1.0,19.651484454403228,1.0917491363557348,0.00242740543524258,1,0
ServerResponse.java,created,3,8,4,12,11,16,55.35090589819676,2.25,124.5395382709427,6.918863237274595,0.00831285578253799,1,0
ServerResponse.java,accepted,5,8,7,10,13,17,62.907475208398566,3.125,196.5858600262455,10.92143666812475,0.011269732209158166,1,0
ServerResponse.java,seeOther,3,8,4,12,11,16,55.35090589819676,2.25,124.5395382709427,6.918863237274595,0.00831285578253799,1,0
ServerResponse.java,temporaryRedirect,3,8,4,12,11,16,55.35090589819676,2.25,124.5395382709427,6.918863237274595,0.00831285578253799,1,0
ServerResponse.java,permanentRedirect,3,8,4,12,11,16,55.35090589819676,2.25,124.5395382709427,6.918863237274595,0.00831285578253799,1,0
ServerResponse.java,badRequest,5,8,7,10,13,17,62.907475208398566,3.125,196.5858600262455,10.92143666812475,0.011269732209158166,1,0
ServerResponse.java,unprocessableEntity,5,61,56,124,66,180,1087.9909414845215,5.081967213114754,5529.1342927901915,307.1741273772329,0.10422778396983978,4,0
ScheduledExecutorFactoryBeanTests.java,pauseToLetTaskStart,5,11,5,13,16,18,72.0,2.9545454545454546,212.72727272727272,11.818181818181818,0.011878479707948477,2,0
ApiVersionInserter.java,useHeader,3,8,3,10,11,13,44.97261104228487,1.875,84.32364570428413,4.684646983571341,0.0064098076216432855,1,0
ApiVersionInserter.java,useQueryParam,3,8,3,10,11,13,44.97261104228487,1.875,84.32364570428413,4.684646983571341,0.0064098076216432855,1,0
ApiVersionInserter.java,usePathSegment,3,8,3,10,11,13,44.97261104228487,1.875,84.32364570428413,4.684646983571341,0.0064098076216432855,2,0
ApiVersionInserter.java,builder,2,19,2,29,21,31,136.16184010614157,1.5263157894736843,207.82596647779505,11.54588702654417,0.01169531574423841,2,0
CompositeLog.java,initLogger,5,35,51,158,40,209,1112.2829718314588,11.285714285714285,12552.907824955033,697.3837680530573,0.1800424739204899,1,0
PathPatternTests.java,toPathContainer,8,69,94,223,77,317,1986.5713334002837,12.927536231884059,25681.472889754394,1426.748493875244,0.2901518632955224,6,0
AbstractExpressionTests.java,stringValueOf,1,5,1,7,6,8,20.67970000576925,0.7,14.475790004038473,0.8042105557799152,0.00197988634999937,1,0
AbstractExpressionTests.java,stringValueOf,10,32,102,156,42,258,1391.2178950769203,24.375,33910.93619249993,1883.9408995833296,0.34922495098509526,19,0
AbstractCacheOperationTests.java,getCacheName,5,10,6,13,15,19,74.23092131656186,3.25,241.25049427882604,13.402805237712558,0.012917869310319184,1,0
XmlBeanFactoryTests.java,classPathResource,16,476,1903,3911,492,5814,51991.77933404234,65.73109243697479,3417476.4533687327,189859.8029649296,7.5627968139302455,24,0
XmlBeanFactoryTests.java,create,2,5,2,9,7,11,30.880904142633646,1.8,55.58562745674057,3.0880904142633647,0.00485497599449027,1,0
XmlBeanFactoryTests.java,create,5,15,10,35,20,45,194.4867642699313,5.833333333333334,1134.5061249079329,63.02811805044072,0.03625906841971038,1,0
XmlBeanFactoryTests.java,create,2,4,2,6,6,8,20.67970000576925,1.5,31.019550008653873,1.723308333814104,0.003290806962640765,1,0
XmlBeanFactoryTests.java,create,2,4,2,6,6,8,20.67970000576925,1.5,31.019550008653873,1.723308333814104,0.003290806962640765,1,0
XmlBeanFactoryTests.java,create,5,25,19,68,30,87,426.89948181794114,6.800000000000001,2902.916476362,161.27313757566668,0.06783207547965381,1,0
RestTemplate.java,initUriTemplateHandler,17,195,931,1856,212,2787,21537.714306867634,80.9025641025641,1742456.3123340707,96803.12846300393,4.826733759607112,42,0
OrderUtils.java,getOrder,4,5,4,7,9,11,34.86917501586544,2.8,97.63369004442322,5.424093891356845,0.0070677071743472505,3,0
OrderUtils.java,getOrder,7,13,13,24,20,37,159.91133951083242,6.461538461538462,1033.2732706853787,57.404070593632156,0.034068698425056596,5,0
OrderUtils.java,getPriority,5,15,10,19,20,29,125.33591475173351,3.1666666666666665,396.89706338048944,22.049836854471636,0.01800241085373675,4,0
AbstractHttpHandlerIntegrationTestCase.java,url,7,20,28,39,27,67,318.5774626449524,6.825,2174.2911825518,120.7939545862111,0.0559444765973185,4,0
ConversionException.java,defaultMessage,6,13,19,19,19,38,161.42124551085624,4.384615384615384,707.7700764706773,39.320559803926514,0.026473226586864736,1,0
ResourceUrlProvider.java,prependLeadingSlash,12,94,143,220,106,363,2442.235125006441,14.042553191489361,34295.21664902662,1905.289813834812,0.35185828300104127,19,0
SimpleNamingContextBuilder.java,getCurrentContextBuilder,15,59,102,146,74,248,1539.9444346759797,18.559322033898304,28580.324677460976,1587.7958154144987,0.3115947875417372,19,0
DefaultListableBeanFactoryTests.java,createTestBean,12,44,51,132,56,183,1062.7459507365415,18.0,19129.42711325775,1062.7459507365415,0.23842221660356772,4,0
DefaultListableBeanFactoryTests.java,clearInstantiationRecord,1,3,1,3,4,4,8.0,0.5,4.0,0.2222222222222222,0.0008399473665965822,1,0
DefaultListableBeanFactoryTests.java,wasInstantiated,6,30,18,55,36,73,377.40452510528877,5.5,2075.724888079088,115.31804933772712,0.054240698502180884,1,0
NativeMessageHeaderAccessor.java,getFirstNativeHeader,6,12,21,33,18,54,225.17595007788486,8.25,1857.70158814255,103.20564378569722,0.05037279476146874,3,0
MessageHeaderAccessor.java,getMutableAccessor,11,45,58,101,56,159,923.369432607159,12.344444444444445,11398.482662517263,633.2490368065146,0.16882759762348434,7,0
HttpClientErrorException.java,create,1,14,1,20,15,21,82.0447025077789,0.7142857142857143,58.60335893412778,3.255742163007099,0.005029140297137887,1,0
HttpClientErrorException.java,create,5,41,104,660,46,764,4220.001334427558,40.24390243902439,169829.32199525536,9434.962333069743,1.0222423342210358,24,0
EvaluationTests.java,isEven,3,4,5,5,7,10,28.07354922057604,1.875,52.63790478858007,2.924328043810004,0.004681781502311053,1,0
HttpComponentsClientHttpResponse.java,getMaxAgeSeconds,7,25,22,40,32,62,310.0,5.6000000000000005,1736.0000000000002,96.44444444444446,0.04814803407088173,5,0
FreeMarkerViewTests.java,asString,4,16,10,24,20,34,146.94555522617034,3.0,440.83666567851105,24.49092587102839,0.01930770040049198,1,0
BeanFactoryUtils.java,isFactoryDereference,4,7,5,9,11,14,48.432042660922164,2.5714285714285716,124.53953827094271,6.9188632372745955,0.00831285578253799,3,0
BeanFactoryUtils.java,transformedBeanName,3,11,9,21,14,30,114.22064766172812,2.8636363636363638,327.08640012222145,18.17146667345675,0.015824150447202156,2,0
BeanFactoryUtils.java,isGeneratedBeanName,4,6,4,8,10,12,39.86313713864835,2.6666666666666665,106.30169903639559,5.905649946466422,0.007480068056578984,2,0
BeanFactoryUtils.java,originalBeanName,6,9,8,16,15,24,93.76537429460444,5.333333333333333,500.08199623789034,27.78233312432724,0.02100097985297437,1,0
BeanFactoryUtils.java,countBeansIncludingAncestors,12,55,222,399,67,621,3767.0413872742765,43.52727272727273,163969.03783881126,9109.39099104507,0.9985886927263864,64,0
ProxyFactoryBeanTests.java,reset,9,56,53,91,65,144,867.2209650760974,7.3125,6341.553307118962,352.3085170621646,0.11420256113206699,2,0
Literal.java,getIntLiteral,11,31,44,72,42,116,625.5088210423362,12.774193548387098,7990.370746218231,443.90948590101283,0.13322632014960856,7,0
HttpStatusCodeException.java,getMessage,5,11,10,19,16,29,116.0,4.318181818181818,500.90909090909093,27.82828282828283,0.02102412940862831,2,0
AbstractAspectJAdvisorFactoryTests.java,aspectInstanceFactory,16,186,207,522,202,729,5582.836170926058,22.451612903225808,125343.67661175925,6963.53758954218,0.8348600858625488,13,0
RequestMappingHandlerAdapterTests.java,setupOnce,9,170,368,709,179,1077,8060.069592113604,18.76764705882353,151268.54137434385,8403.807854130215,0.9463341038189117,3,0
InvocableHandlerMethod.java,isAsyncVoidReturnType,7,30,28,50,37,78,406.3373625190581,5.833333333333334,2370.3012813611726,131.68340452006515,0.05925810777017884,8,0
InvocableHandlerMethod.java,invokeFunction,13,32,35,59,45,94,516.2341910549894,11.984375,6186.744133424639,343.7080074124799,0.11233631721826462,6,0
DefaultWebClient.java,getUriToLog,9,41,45,89,50,134,756.276729429813,9.76829268292683,7387.532442357077,410.41846901983763,0.12643821208376127,3,0
ConditionalTestCase.java,getDisabledTestCount,5,22,19,35,27,54,256.7639251168273,3.977272727272727,1021.220156714654,56.73445315081411,0.03380324014894276,4,0
PropertySourcesPlaceholderConfigurerTests.java,pspc,3,10,3,11,13,14,51.80615605397529,1.6500000000000001,85.48015748905924,4.748897638281068,0.006468282128597514,1,0
PropertySourcesPlaceholderConfigurerTests.java,pspc,4,4,4,9,8,13,39.0,4.5,175.5,9.75,0.010448729651823922,1,0
MethodValidationTests.java,initHandlerAdapter,12,116,269,647,128,916,6412.0,33.46551724137931,214580.89655172414,11921.16091954023,1.1947382892472995,3,0
MethodValidationTests.java,assertBeanResult,3,16,7,22,19,29,123.18989788986397,2.0625,254.07916439784444,14.11550913321358,0.013371848482530093,1,0
MethodValidationTests.java,assertValueResult,9,87,124,252,96,376,2475.9459002711546,13.03448275862069,32272.674148361948,1792.9263415756639,0.33788484574293537,2,0
InternalConfigurationPostProcessor.java,isConfigClass,5,10,7,13,15,20,78.13781191217038,3.25,253.94788871455373,14.10821603969743,0.01336724217607629,1,0
RSocketClientToServerIntegrationTests.java,setupOnce,5,30,28,38,35,66,338.53267911836775,3.1666666666666665,1072.0201505414977,59.556675030083206,0.03491516063618052,1,0
RSocketClientToServerIntegrationTests.java,tearDownOnce,11,99,249,381,110,630,4272.256619520535,21.166666666666668,90429.43177985134,5023.857321102852,0.6715607104770333,2,0
CommonAnnotationBeanRegistrationAotContributionTests.java,getSourceFile,7,54,62,94,61,156,925.1950246598103,6.092592592592593,5636.8363539458815,313.15757521921563,0.10557693012067099,1,0
HandlerStrategies.java,withDefaults,2,4,2,4,6,6,15.509775004326936,1.0,15.509775004326936,0.861654166907052,0.0020730784816858556,2,0
HandlerStrategies.java,builder,4,4,4,8,8,12,36.0,4.0,144.0,8.0,0.009157713940426653,2,0
HandlerStrategies.java,empty,5,20,12,30,25,42,195.04195997053841,3.75,731.4073498895191,40.63374166052884,0.027059408071107995,3,0
AnnotatedElementUtilsTests.java,findMergedAnnotationAttributes,6,126,127,521,132,648,4564.767389344278,12.404761904761905,56624.852615437354,3145.8251453020753,0.49153011925021656,3,0
MergedSqlConfigTests.java,localConfigMethodWithDuplicatedCommentPrefixes,0,2,0,2,2,2,2.0,0.0,0.0,0.0,0,1,0
MergedSqlConfigTests.java,localConfigMethodWithDefaults,1,15,10,15,16,25,100.0,0.5,50.0,2.7777777777777777,0.004524029360991511,1,0
MergedSqlConfigTests.java,localConfigMethodWithCustomValues,1,5,2,5,6,7,18.094737505048094,0.5,9.047368752524047,0.5026315973624471,0.0014473057017609214,1,0
MergedSqlConfigTests.java,localConfigMethodWithEmptyCommentPrefix,1,5,2,5,6,7,18.094737505048094,0.5,9.047368752524047,0.5026315973624471,0.0014473057017609214,1,0
MergedSqlConfigTests.java,localConfigMethodWithEmptyCommentPrefixes,1,5,2,5,6,7,18.094737505048094,0.5,9.047368752524047,0.5026315973624471,0.0014473057017609214,1,0
MergedSqlConfigTests.java,localConfigMethodWithCustomCommentPrefixes,1,5,2,5,6,7,18.094737505048094,0.5,9.047368752524047,0.5026315973624471,0.0014473057017609214,1,0
MergedSqlConfigTests.java,localConfigMethodWithMultipleCommentPrefixes,1,6,2,6,7,8,22.458839376460833,0.5,11.229419688230417,0.6238566493461343,0.0016715406947905174,1,0
MergedSqlConfigTests.java,localConfigMethodWithContinueOnError,1,6,2,6,7,8,22.458839376460833,0.5,11.229419688230417,0.6238566493461343,0.0016715406947905174,1,0
MergedSqlConfigTests.java,localConfigMethodWithIgnoreFailedDrops,1,25,36,96,26,132,620.4580427946241,1.92,1191.2794421656783,66.18219123142657,0.037458856026305824,1,0
Jackson2JsonEncoder.java,initSsePrettyPrinter,9,30,20,41,39,61,322.4095353505972,6.15,1982.8186424061728,110.15659124478738,0.05260989167776261,1,0
ConcurrentBeanWrapperTests.java,performSet,12,50,52,97,62,149,887.1752502476444,11.64,10326.719912882581,573.7066618268101,0.15807153741099828,6,0
SpelUtilities.java,printAbstractSyntaxTree,2,8,9,15,10,24,79.7262742772967,1.875,149.4867642699313,8.304820237218406,0.009388882548620756,2,0
SpelUtilities.java,printAST,7,17,25,41,24,66,302.6075250475963,8.441176470588236,2554.3635202547102,141.909084458595,0.06228744941196704,3,0
BridgeMethodResolverTests.java,findMethodWithReturnType,13,311,824,1860,324,2684,22384.157407742332,38.87459807073955,870175.1223781505,48343.062354341695,3.0382011277840073,8,0
ResourceHttpMessageWriter.java,getResourceMediaType,7,11,14,24,18,38,158.45715005480787,7.636363636363636,1210.036418600351,67.22424547779728,0.03785103037498381,2,0
ResourceHttpMessageWriter.java,lengthOf,14,113,147,263,127,410,2865.360721576588,16.292035398230087,46682.558304623875,2593.475461367993,0.4321639246024758,9,0
ConversionServiceFactory.java,registerConverters,10,14,34,29,24,63,288.85263754543286,10.357142857142858,2991.6880317205546,166.2048906511419,0.06920799717934892,6,0
ConversionServiceFactory.java,createDefaultConversionService,2,3,2,3,5,5,11.60964047443681,1.0,11.60964047443681,0.6449800263576005,0.00170906242423416,1,0
ConversionServiceFactory.java,addDefaultConverters,1,4,1,6,5,7,16.253496664211536,0.75,12.190122498158651,0.6772290276754807,0.0017655666841127381,1,0
OrderComparator.java,sort,4,6,6,9,10,15,49.82892142331043,3.0,149.4867642699313,8.304820237218406,0.009388882548620756,3,0
OrderComparator.java,sort,2,6,3,9,8,12,36.0,1.5,54.0,3.0,0.004762203155904598,4,0
OrderComparator.java,sortIfNecessary,4,9,5,19,13,24,88.81055323538621,4.222222222222222,374.9778914382973,20.832105079905407,0.01733335055338162,9,0
WebClient.java,create,6,62,45,124,68,169,1028.7812201713073,6.0,6172.687321027844,342.92707339043574,0.11216609422982969,14,0
ResourceUrlProviderTests.java,pattern,9,18,13,36,27,49,232.98948760600993,9.0,2096.9053884540895,116.49474380300497,0.05460905179896727,2,0
TestResourceUtils.java,qualifiedResource,6,8,6,12,14,18,68.53238859703687,4.5,308.3957486866659,17.133097149259218,0.01521543361852368,1,0
ParameterContentTypeResolver.java,formatKey,10,39,45,74,49,119,668.1504714497098,9.487179487179487,6338.86344708699,352.1590803937217,0.11417026508824527,3,0
DefaultAsyncServerResponse.java,create,11,28,40,61,39,101,533.8256241050872,11.982142857142856,6396.374888830597,355.35416049058875,0.11485979011978285,5,0
JRubyScriptUtils.java,createJRubyObject,7,27,19,44,34,63,320.5101589987714,5.703703703703703,1828.0949809559552,101.56083227533084,0.04983616130127416,4,0
JRubyScriptUtils.java,initializeRuntime,2,6,3,6,8,9,27.0,1.0,27.0,1.5,0.002999999999999999,2,0
JRubyScriptUtils.java,findClassName,6,13,11,19,19,30,127.43782540330756,4.384615384615384,558.7658498452715,31.042547213626197,0.02261337139783826,4,0
JRubyScriptUtils.java,findClassNode,14,86,115,245,100,360,2391.7882283189006,19.94186046511628,47696.707111243195,2649.817061735733,0.4384004690103267,18,0
JRubyScriptUtils.java,buildMessage,6,10,10,16,16,26,104.0,4.800000000000001,499.20000000000005,27.733333333333334,0.020976279591261516,1,0
AbstractDelegatingSmartContextLoader.java,delegateProcessing,7,25,24,57,32,81,405.0,7.9799999999999995,3231.8999999999996,179.54999999999998,0.07286472916555373,4,0
AbstractDelegatingSmartContextLoader.java,name,2,6,3,7,8,10,30.0,1.1666666666666667,35.0,1.9444444444444444,0.0035666249352169313,1,0
DefaultEntityResponseBuilder.java,getContentType,16,103,171,386,119,557,3840.413494162525,29.980582524271846,115137.83368906677,6396.546316059265,0.7889039210096782,15,0
ControllerMethodResolverTests.java,next,5,42,11,68,47,79,438.81251928253334,4.0476190476190474,1776.1459113816825,98.67477285453792,0.04888750111992401,1,0
AutowiredAnnotationBeanPostProcessorTests.java,createPlain,5,30,36,84,35,120,615.513962033396,7.0,4308.597734233772,239.3665407907651,0.08826110853545578,1,0
AnnotationDrivenCacheBeanDefinitionParser.java,parseCacheResolution,5,17,14,30,22,44,196.21499122004107,4.411764705882353,865.654373029593,48.09190961275517,0.0302766925082282,3,0
AnnotationDrivenCacheBeanDefinitionParser.java,parseErrorHandler,3,15,7,19,18,26,108.41805003750011,1.9,205.9942950712502,11.444127503958345,0.011626496732672943,2,0
AnnotationDrivenCacheBeanDefinitionParser.java,registerCacheAdvisor,5,44,58,122,49,180,1010.6477719407375,6.9318181818181825,7005.62660095284,389.2014778307133,0.12204221159022224,3,0
AnnotationDrivenCacheBeanDefinitionParser.java,registerCacheAspect,5,21,13,33,26,46,216.22022703449022,3.9285714285714284,849.4366062069258,47.19092256705144,0.029897352171260366,2,0
AnnotationDrivenCacheBeanDefinitionParser.java,registerCacheAdvisor,5,39,51,107,44,158,862.590195744693,6.8589743589743595,5916.484034915523,328.69355749530683,0.1090405106236116,3,0
AnnotationDrivenCacheBeanDefinitionParser.java,registerCacheAspect,5,34,31,65,39,96,507.3986130107759,4.779411764705882,2425.0669004191495,134.72593891217497,0.06016739766134512,2,0
AnnotationDrivenCacheBeanDefinitionParser.java,createJCacheOperationSourceBeanDefinition,4,16,7,26,20,33,142.62362713128297,3.25,463.52678817666964,25.751488232037204,0.019964662394435572,1,0
SimpMessageHeaderAccessor.java,create,2,3,2,4,5,6,13.931568569324174,1.3333333333333333,18.575424759098897,1.0319680421721609,0.002337964509447503,1,0
SimpMessageHeaderAccessor.java,create,2,5,2,7,7,9,25.26619429851844,1.4,35.372672017925815,1.965148445440323,0.0035918979562143964,1,0
SimpMessageHeaderAccessor.java,wrap,6,16,13,28,22,41,182.83669636412918,5.25,959.8926559116782,53.32736977287101,0.032435992492702126,3,0
SimpMessageHeaderAccessor.java,getMessageType,4,16,6,24,20,30,129.65784284662087,3.0,388.9735285398626,21.609640474436812,0.017762009976565858,2,0
SimpMessageHeaderAccessor.java,getDestination,4,13,5,21,17,26,106.27403387250882,3.230769230769231,343.3468786650285,19.074826592501584,0.016344343499188157,3,0
SimpMessageHeaderAccessor.java,getSubscriptionId,4,13,5,21,17,26,106.27403387250882,3.230769230769231,343.3468786650285,19.074826592501584,0.016344343499188157,2,0
SimpMessageHeaderAccessor.java,getSessionId,4,19,20,54,23,74,334.74358474821895,5.684210526315789,1902.7530080425076,105.70850044680599,0.05118393722202571,4,0
SimpMessageHeaderAccessor.java,getUser,4,8,4,10,12,14,50.18947501009619,2.5,125.47368752524048,6.970760418068916,0.008354372837992952,1,0
NettyDataBufferFactory.java,toByteBuf,4,14,10,18,18,28,116.75790004038474,2.5714285714285716,300.2346001038465,16.67970000576925,0.01494580249624294,2,0
MergedSqlConfig.java,getString,10,61,89,182,71,271,1666.581469385769,14.918032786885247,24862.117002312294,1381.228722350683,0.2839471294547825,7,0
ServletServerHttpRequest.java,initUri,9,20,18,31,29,49,238.041068761251,6.9750000000000005,1660.336454609726,92.24091414498477,0.046738648225355596,3,0
ServletServerHttpRequest.java,initHeaders,13,109,150,292,122,442,3063.385903202796,17.412844036697248,53342.26095668721,2963.4589420381785,0.472345401585619,15,0
ProfilesTests.java,assertMalformed,10,26,32,46,36,78,403.2541501125003,8.846153846153847,3567.2482509951956,198.180458388622,0.0778217455314522,3,0
XStreamMarshallerTests.java,assertXpathExists,6,17,11,23,23,34,153.80110650593844,4.0588235294117645,624.2515499358677,34.68064166310376,0.024347357433657933,2,0
XStreamMarshallerTests.java,assertXpathDoesNotExist,6,17,11,23,23,34,153.80110650593844,4.0588235294117645,624.2515499358677,34.68064166310376,0.024347357433657933,2,0
ExpressionTestCase.java,stringValueOf,1,5,1,7,6,8,20.67970000576925,0.7,14.475790004038473,0.8042105557799152,0.00197988634999937,1,0
ExpressionTestCase.java,stringValueOf,10,32,102,156,42,258,1391.2178950769203,24.375,33910.93619249993,1883.9408995833296,0.34922495098509526,19,0
MediaType.java,valueOf,1,5,1,6,6,7,18.094737505048094,0.6,10.856842503028856,0.6031579168349365,0.001634360172194361,2,0
MediaType.java,parseMediaType,10,36,67,106,46,173,955.5762183978633,14.722222222222223,14068.205437524099,781.5669687513388,0.19425455583656392,12,0
MediaType.java,asMediaType,4,8,7,15,12,22,78.86917501586544,3.75,295.7594063094954,16.4310781283053,0.014796913072860659,4,0
MediaType.java,toString,4,7,4,9,11,13,44.97261104228487,2.5714285714285716,115.64385696587539,6.42465872032641,0.007912136854124296,7,0
MediaType.java,sortBySpecificity,3,10,6,13,13,19,70.30835464468075,1.9500000000000002,137.10129155712747,7.616738419840415,0.008862844086047534,8,0
MediaType.java,sortByQualityValue,3,10,6,13,13,19,70.30835464468075,1.9500000000000002,137.10129155712747,7.616738419840415,0.008862844086047534,2,0
MediaType.java,sortBySpecificityAndQuality,10,34,78,101,44,179,977.2382597360762,14.852941176470589,14514.862387256426,806.3812437364682,0.198344742769166,10,0
PayloadUtils.java,retainDataAndReleasePayload,7,15,14,25,22,39,173.9178331268546,5.833333333333334,1014.5206932399852,56.362260735554734,0.03365523947498429,5,0
PayloadUtils.java,createPayload,4,12,18,36,16,54,216.0,6.0,1296.0,72.0,0.03962312698673551,4,0
PayloadUtils.java,createPayload,3,11,11,22,14,33,125.64271242790093,3.0,376.92813728370277,20.94045207131682,0.017393398644619574,3,0
ClassPathBeanDefinitionScanner.java,getOrCreateEnvironment,5,10,10,13,15,23,89.85848369899593,3.25,292.04007202173676,16.224448445652044,0.014672598820854352,2,0
ApplicationContextAotGeneratorTests.java,registerBeanPostProcessor,4,14,8,17,18,25,104.2481250360578,2.4285714285714284,253.17401794471178,14.065223219150655,0.01334007182736957,1,0
ApplicationContextAotGeneratorTests.java,registerStringBean,1,11,5,16,12,21,75.28421251514428,0.7272727272727273,54.75215455646857,3.041786364248254,0.004806322274181696,1,0
ApplicationContextAotGeneratorTests.java,registerIntegerBean,6,28,23,34,34,57,289.98538195126935,3.6428571428571423,1056.3753199653381,58.687517775852115,0.03457463277917224,1,0
ApplicationContextAotGeneratorTests.java,processAheadOfTime,4,8,7,17,12,24,86.03910001730775,4.25,365.6661750735579,20.31478750408655,0.01704519358507665,1,0
ApplicationContextAotGeneratorTests.java,testCompiledResult,2,9,4,13,11,17,58.81033751683405,1.4444444444444444,84.94826530209363,4.719348072338535,0.006441422042478048,1,0
ApplicationContextAotGeneratorTests.java,testCompiledResult,4,15,12,20,19,32,135.93368043019473,2.6666666666666665,362.48981448051927,20.138323026695517,0.01694634136647107,1,0
ApplicationContextAotGeneratorTests.java,toFreshApplicationContext,5,7,5,12,12,17,60.94436251225965,4.285714285714286,261.19012505254136,14.510562502918965,0.013620192556615722,1,0
ApplicationContextAotGeneratorTests.java,createFreshApplicationContext,7,25,9,38,32,47,235.0,5.32,1250.2,69.45555555555556,0.03868403269349911,1,0
DefaultWebFilterChain.java,initChain,10,34,52,100,44,152,829.8336060328692,14.705882352941178,12203.435382836313,677.9686323797952,0.17668519055125892,2,0
WebAsyncManager.java,formatUri,5,13,6,16,18,22,91.73835003173087,3.076923076923077,282.27184625147964,15.681769236193313,0.014343565507099103,2,0
GroupsMetadataValueDelegateTests.java,getGeneratedCodeReturnValue,7,21,16,30,28,46,221.13832641464978,5.0,1105.691632073249,61.42731289295827,0.035642494712041006,2,0
DataBufferUtils.java,closeChannel,14,45,92,129,59,221,1300.0641139089669,20.066666666666666,26087.953219106603,1449.3307343948113,0.2932054802037014,9,0
DataBufferUtils.java,release,12,39,50,76,51,126,714.7255930884083,11.692307692307692,8356.791549956773,464.26619721982075,0.13726878558923442,11,0
DataBufferUtils.java,matcher,1,5,1,6,6,7,18.094737505048094,0.6,10.856842503028856,0.6031579168349365,0.001634360172194361,2,0
DataBufferUtils.java,matcher,6,9,12,14,15,26,101.57915548582149,4.666666666666667,474.03605893383366,26.335336607435202,0.020265298159505275,1,0
DataBufferUtils.java,createMatcher,16,120,395,804,136,1199,8497.867946659157,53.6,455485.7219409308,25304.76233005171,1.9733097290797799,42,0
PubSubHeaders.java,create,3,5,3,7,8,10,30.0,2.0999999999999996,62.999999999999986,3.499999999999999,0.0052776320879040755,2,0
PubSubHeaders.java,create,2,5,2,8,7,10,28.07354922057604,1.6,44.91767875292167,2.495426597384537,0.00421201861424495,1,0
PubSubHeaders.java,fromMessageHeaders,11,58,99,194,69,293,1789.7976658360035,18.39655172413793,32926.105335293374,1829.2280741829652,0.3424304060024381,6,0
ComponentBeanDefinitionParser.java,parseComponentElement,6,18,12,27,24,39,178.8135375281251,4.5,804.660918876563,44.703384382031274,0.028837261642555595,2,0
ComponentBeanDefinitionParser.java,parseComponent,3,11,7,15,14,22,83.76180828526729,2.0454545454545454,171.3309714925922,9.51838730514401,0.010282593413122149,1,0
ComponentBeanDefinitionParser.java,parseChildComponents,5,14,11,22,19,33,140.1816079436383,3.9285714285714284,550.713459778579,30.595192209921056,0.022395591604530952,2,0
AnnotationConfigContextLoaderUtils.java,isDefaultConfigurationClassCandidate,7,8,10,12,15,22,85.95159310338741,5.25,451.2458637927839,25.06921465515466,0.019610450383863158,1,0
AnnotationConfigContextLoaderUtils.java,isStaticNonPrivateAndNonFinal,8,11,14,18,19,32,135.93368043019473,6.545454545454546,889.7477264521838,49.43042924734354,0.03083590293301871,1,0
ComponentScanAnnotationIntegrationTests.java,customAutowireConfigurer,4,35,36,63,39,99,523.2548196673627,3.6,1883.7173508025055,104.65096393347253,0.05084199348510454,1,0
ConfigurationClassUtils.java,checkConfigurationClassCandidate,13,34,30,62,47,92,511.02217435434267,11.852941176470589,6057.11577249412,336.5064318052289,0.11076162745856963,11,0
ConfigurationClassUtils.java,isConfigurationCandidate,2,5,2,7,7,9,25.26619429851844,1.4,35.372672017925815,1.965148445440323,0.0035918979562143964,1,0
ConfigurationClassUtils.java,isFullConfigurationCandidate,2,6,4,7,8,11,33.0,1.1666666666666667,38.5,2.138888888888889,0.0038006035086747304,1,0
ConfigurationClassUtils.java,isLiteConfigurationCandidate,5,9,11,13,14,24,91.3765181293825,3.611111111111111,329.97075991165906,18.331708883981058,0.01591704276938352,1,0
ConfigurationClassUtils.java,isFullConfigurationClass,2,7,3,8,9,11,34.86917501586544,1.1428571428571428,39.85048573241764,2.2139158740232023,0.0038889690914361732,1,0
XmlBeanFactoryTestTypes.java,nullInstance,1,3,1,3,4,4,8.0,0.5,4.0,0.2222222222222222,0.0008399473665965822,1,0
XmlBeanFactoryTestTypes.java,defaultInstance,4,5,5,9,9,14,44.37895002019237,3.6,159.76422007269252,8.875790004038473,0.00981443028353454,1,0
XmlBeanFactoryTestTypes.java,newInstance,2,4,3,6,6,9,23.264662506490403,1.5,34.89699375973561,1.938721875540867,0.0035596236958749536,1,0
XmlBeanFactoryTestTypes.java,newInstance,4,9,7,14,13,21,77.70923408096293,3.111111111111111,241.762061585218,13.431225643623222,0.012936124267933505,2,0
XmlBeanFactoryTestTypes.java,newInstance,14,114,171,383,128,554,3878.0,23.517543859649123,91201.0350877193,5066.724171539961,0.6753754297167335,20,0
GenericTypeResolver.java,getTargetType,12,80,180,270,92,450,2935.602880225656,20.25,59445.95832456953,3302.553240253863,0.5077231514541556,37,0
GenericTypeResolver.java,buildTypeVaraibleMap,8,26,37,65,34,102,518.9212098075346,10.0,5189.212098075346,288.2895610041859,0.09991093575942152,9,0
GenericTypeResolver.java,getRawType,6,13,14,33,19,47,199.6525931318485,7.615384615384615,1520.431286157923,84.46840478655128,0.044074758735837855,5,0
GenericTypeResolver.java,extractBoundForTypeVariable,6,26,32,69,32,101,505.0,7.961538461538462,4020.5769230769233,223.36538461538464,0.08428254912159742,5,0
MockHttpServletRequestBuilderTests.java,requestAttr,4,17,12,46,21,58,254.75441052116813,5.411764705882353,1378.6709275263217,76.59282930701788,0.04129072327588015,1,0
CronField.java,zeroNanos,2,3,2,4,5,6,13.931568569324174,1.3333333333333333,18.575424759098897,1.0319680421721609,0.002337964509447503,1,0
CronField.java,parseSeconds,2,5,2,7,7,9,25.26619429851844,1.4,35.372672017925815,1.965148445440323,0.0035918979562143964,1,0
CronField.java,parseMinutes,2,5,2,7,7,9,25.26619429851844,1.4,35.372672017925815,1.965148445440323,0.0035918979562143964,1,0
CronField.java,parseHours,2,5,2,7,7,9,25.26619429851844,1.4,35.372672017925815,1.965148445440323,0.0035918979562143964,1,0
CronField.java,parseDaysOfMonth,5,12,13,25,17,38,155.32358796751288,5.208333333333334,808.9770206641297,44.94316781467387,0.02894028934800422,3,0
CronField.java,parseMonth,3,7,3,11,10,14,46.50699332842307,2.357142857142857,109.62362713128296,6.090201507293497,0.007635102239890672,1,0
CronField.java,parseDaysOfWeek,6,14,14,29,20,43,185.8429080801566,6.214285714285715,1154.8809287838305,64.16005159910169,0.03669190145046482,3,0
CronField.java,parseList,7,19,17,41,26,58,272.62550365218334,7.552631578947368,2059.039988109911,114.39111045055061,0.05394964599609393,2,0
CronField.java,replaceOrdinals,14,79,152,294,93,446,2916.4648297541817,26.050632911392405,75975.75467891274,4220.875259939597,0.5979461772638471,17,0
DerivedTestBean.java,create,5,23,18,47,28,65,312.4780699337442,5.108695652173914,1596.3553572702153,88.68640873723419,0.04553008502385875,2,0
RestClientAdapterTests.java,anotherServer,6,61,32,130,67,162,982.706448854159,6.39344262295082,6282.8772959528205,349.0487386640456,0.1134970213675033,1,0
ClientCodecConfigurer.java,create,5,16,12,24,21,36,158.12342722003538,3.75,592.9628520751327,32.942380670840706,0.02352684744014138,7,0
HttpMethod.java,valueOf,5,12,7,19,17,26,106.27403387250882,3.958333333333333,420.6680507453474,23.37044726363041,0.01871422146712529,3,0
HttpMethod.java,resolve,6,21,26,56,27,82,389.9007751774044,8.0,3119.206201419235,173.28923341217973,0.07116090604391874,4,0
AbstractEntityManagerFactoryIntegrationTests.java,closeContext,9,49,62,106,58,168,984.140807181432,9.73469387755102,9580.309490317206,532.2394161287336,0.15035981107534227,7,0
ObjectUtils.java,isCheckedException,4,5,5,7,9,12,38.039100017307746,2.8,106.50948004846168,5.917193336025649,0.0074898120854058154,1,0
ObjectUtils.java,isCompatibleWithThrowsClause,7,13,12,22,20,34,146.94555522617034,5.923076923076923,870.3698271088551,48.353879283825286,0.030386543163120658,5,0
ObjectUtils.java,isArray,4,5,5,8,9,13,41.209025018750054,3.2,131.86888006000018,7.326048892222232,0.008635887122716674,1,0
ObjectUtils.java,isEmpty,4,5,7,7,9,14,44.37895002019237,2.8,124.26106005653862,6.903392225363257,0.008300459115293854,3,0
ObjectUtils.java,containsElement,2,9,5,16,11,21,72.64806399138324,1.7777777777777777,129.1521137624591,7.1751174312477275,0.008516864886769126,5,0
ObjectUtils.java,containsConstant,4,6,4,9,10,13,43.18506523353571,3.0,129.55519570060713,7.197510872255951,0.008534576359217054,2,0
ObjectUtils.java,containsConstant,13,43,97,140,56,237,1376.343116527652,21.162790697674417,29127.26130325961,1618.1811835144226,0.31555750473498717,20,0
ObjectUtils.java,nullSafeEquals,6,14,62,94,20,156,674.2207828024285,20.142857142857142,13580.73291073463,754.4851617074795,0.18974086845078958,16,0
ObjectUtils.java,nullSafeHashCode,4,10,25,45,14,70,266.5148445440323,9.0,2398.633600896291,133.25742227201616,0.059729381922180046,12,0
ObjectUtils.java,nullSafeHashCode,6,10,14,21,16,35,140.0,6.300000000000001,882.0000000000001,49.00000000000001,0.03065663397921522,3,0
ObjectUtils.java,nullSafeHashCode,6,10,14,20,16,34,136.0,6.0,816.0,45.333333333333336,0.029107540994418497,3,0
ObjectUtils.java,nullSafeHashCode,6,10,14,20,16,34,136.0,6.0,816.0,45.333333333333336,0.029107540994418497,3,0
ObjectUtils.java,nullSafeHashCode,6,9,14,19,15,33,128.92738965508113,6.333333333333334,816.5401344821805,45.36334080456558,0.02912038433806078,3,0
ObjectUtils.java,nullSafeHashCode,6,10,14,20,16,34,136.0,6.0,816.0,45.333333333333336,0.029107540994418497,3,0
ObjectUtils.java,nullSafeHashCode,6,10,14,20,16,34,136.0,6.0,816.0,45.333333333333336,0.029107540994418497,3,0
ObjectUtils.java,nullSafeHashCode,6,9,14,19,15,33,128.92738965508113,6.333333333333334,816.5401344821805,45.36334080456558,0.02912038433806078,3,0
ObjectUtils.java,nullSafeHashCode,6,11,14,21,17,35,143.06119944376186,5.7272727272727275,819.3505059051816,45.51947255028787,0.029187163845473933,3,0
ObjectUtils.java,nullSafeHashCode,6,10,14,20,16,34,136.0,6.0,816.0,45.333333333333336,0.029107540994418497,3,0
ObjectUtils.java,hashCode,2,2,2,3,4,5,10.0,1.5,15.0,0.8333333333333334,0.002027400665191133,1,0
ObjectUtils.java,hashCode,3,6,3,9,9,12,38.039100017307746,2.25,85.58797503894243,4.754887502163468,0.006473720020679235,1,0
ObjectUtils.java,hashCode,2,4,2,5,6,7,18.094737505048094,1.25,22.61842188131012,1.2565789934061178,0.0026659598967245317,1,0
ObjectUtils.java,hashCode,3,3,5,5,6,10,25.84962500721156,2.5,64.62406251802891,3.5902256954460503,0.0053679473714064695,3,0
ObjectUtils.java,identityToString,4,9,8,12,13,20,74.00879436282185,2.6666666666666665,197.3567849675249,10.964265831529161,0.011299176337733025,2,0
ObjectUtils.java,getIdentityHexString,2,7,3,8,9,11,34.86917501586544,1.1428571428571428,39.85048573241764,2.2139158740232023,0.0038889690914361732,4,0
ObjectUtils.java,getDisplayString,2,7,4,9,9,13,41.209025018750054,1.2857142857142858,52.98303216696436,2.9435017870535756,0.004702223683603679,4,0
ObjectUtils.java,nullSafeClassName,4,8,5,10,12,15,53.77443751081734,2.5,134.43609377704337,7.468671876502409,0.008747608446530022,4,0
ObjectUtils.java,nullSafeToString,6,12,28,54,18,82,341.9338501182696,13.5,4616.1069765966395,256.4503875887022,0.09241220266418278,14,0
ObjectUtils.java,nullSafeToString,6,17,23,37,23,60,271.4137173634208,6.529411764705882,1772.1719192552769,98.45399551418205,0.048814552509610226,7,0
ObjectUtils.java,nullSafeToString,6,15,22,34,21,56,245.9697756756106,6.8,1672.5944745941522,92.92191525523067,0.046968409134201784,7,0
ObjectUtils.java,nullSafeToString,6,16,22,35,22,57,254.18760226232595,6.5625,1668.106139846514,92.67256332480633,0.04688434638346404,7,0
ObjectUtils.java,nullSafeToString,6,15,24,36,21,60,263.53904536672565,7.199999999999999,1897.4811266404245,105.41561814669025,0.05108935132356844,7,0
ObjectUtils.java,nullSafeToString,6,15,22,34,21,56,245.9697756756106,6.8,1672.5944745941522,92.92191525523067,0.046968409134201784,7,0
ObjectUtils.java,nullSafeToString,6,15,22,34,21,56,245.9697756756106,6.8,1672.5944745941522,92.92191525523067,0.046968409134201784,7,0
ObjectUtils.java,nullSafeToString,6,15,22,34,21,56,245.9697756756106,6.8,1672.5944745941522,92.92191525523067,0.046968409134201784,7,0
ObjectUtils.java,nullSafeToString,6,16,22,35,22,57,254.18760226232595,6.5625,1668.106139846514,92.67256332480633,0.04688434638346404,7,0
ObjectUtils.java,nullSafeToString,6,16,22,35,22,57,254.18760226232595,6.5625,1668.106139846514,92.67256332480633,0.04688434638346404,5,0
AggressiveFactoryBeanInstantiationTests.java,callInClinit,2,2,2,2,4,4,8.0,1.0,8.0,0.4444444444444444,0.0013333333333333333,1,0
Configuration.java,empty,2,3,2,3,5,5,11.60964047443681,1.0,11.60964047443681,0.6449800263576005,0.00170906242423416,2,0
Configuration.java,builder,4,4,4,8,8,12,36.0,4.0,144.0,8.0,0.009157713940426653,3,0
Configuration.java,applicationContext,7,21,29,42,28,71,341.32219946608984,7.0,2389.255396262629,132.7364109034794,0.05957359322144005,5,0
GenericBean.java,createInstance,4,5,4,7,9,11,34.86917501586544,2.8,97.63369004442322,5.424093891356845,0.0070677071743472505,1,0
GenericBean.java,createInstance,4,8,6,11,12,17,60.94436251225965,2.75,167.59699690871403,9.310944272706335,0.01013264670209245,1,0
GenericBean.java,createInstance,4,8,6,12,12,18,64.5293250129808,3.0,193.58797503894243,10.754887502163468,0.01115486529067118,1,0
GenericBean.java,createInstance,4,8,4,11,12,15,53.77443751081734,2.75,147.8797031547477,8.21553906415265,0.009321471126980887,1,0
GenericBean.java,createInstance,4,7,4,11,11,15,51.89147427955946,3.142857142857143,163.08749059290116,9.060416144050064,0.009950063342914196,1,0
GenericBean.java,createInstance,5,5,5,7,10,12,39.86313713864835,3.5,139.5209799852692,7.751165554737178,0.00896681942530452,1,0
GenericBean.java,createInstance,5,9,7,12,14,19,72.33974351909448,3.333333333333333,241.13247839698158,13.39624879983231,0.01291365615678232,1,0
ScriptUtils.java,maybeAddSeparatorToScript,4,12,19,28,16,47,188.0,4.666666666666667,877.3333333333334,48.74074074074074,0.03054840212095397,5,0
ScriptUtils.java,containsSqlScriptDelimiters,15,60,82,146,75,228,1420.1706614330608,18.25,25918.11457115336,1439.8952539529646,0.2919315381355186,18,0
RSocketStrategies.java,create,3,5,4,5,8,9,27.0,1.5,40.5,2.25,0.0039311120913133445,2,0
RSocketStrategies.java,builder,7,27,31,48,34,79,401.9095644587768,6.222222222222221,2500.7706232990554,138.93170129439196,0.06141314210922401,14,0
ConfigurationClassAndBFPPTests.java,testBean,2,2,2,3,4,5,10.0,1.5,15.0,0.8333333333333334,0.002027400665191133,1,0
MethodValidationAdapterTests.java,assertBeanResult,3,22,12,35,25,47,218.26124091941205,2.3863636363636362,520.8506885576878,28.93614936431599,0.021578482859504245,1,0
MethodValidationAdapterTests.java,assertValueResult,3,19,10,28,22,38,169.4584015082173,2.2105263157894735,374.5922559655329,20.81068088697405,0.017321464517369545,1,0
MethodValidationAdapterTests.java,getMethod,8,31,14,44,39,58,306.5533286940104,5.67741935483871,1740.4318016176076,96.69065564542264,0.04822994338274718,1,0
DependencyDescriptor.java,isNullable,8,10,10,13,18,23,95.90827503317318,5.2,498.72303017250056,27.706835009583365,0.020962916014355668,1,0
AsmUtils.java,convertClassNameToInternalName,3,4,4,6,7,10,28.07354922057604,2.25,63.16548574629609,3.509193652572005,0.00528687008762814,2,0
AsmUtils.java,convertTypeDescriptorToClassName,5,15,30,43,20,73,315.50075092677747,7.166666666666667,2261.0887149752384,125.61603972084657,0.05742360852088893,10,0
AsmUtils.java,getReturnTypeFromMethodDescriptor,4,7,7,12,11,19,65.72920075410865,3.4285714285714284,225.3572597283725,12.51984776268736,0.012344109930977015,4,0
AsmUtils.java,newClassReader,4,7,5,11,11,16,55.35090589819676,3.142857142857143,173.95998996576122,9.664443886986735,0.010387514935668073,2,0
AsmUtils.java,newClassReader,2,3,3,6,5,9,20.89735285398626,2.0,41.79470570797252,2.321928094887362,0.004014451908823155,2,0
AsmUtils.java,newClassReader,8,9,13,17,17,30,122.62388523751017,7.555555555555555,926.4915773500768,51.47175429722649,0.031679116593066395,5,0
DataBufferUtilsTests.java,assertReleased,11,132,272,553,143,825,5906.893852842171,23.041666666666668,136104.6791925717,7561.371066253983,0.881984154473804,2,0
StringDecoder.java,textPlainOnly,1,4,1,5,5,6,13.931568569324174,0.625,8.707230355827608,0.48373501976820044,0.0014107999471601703,2,0
StringDecoder.java,textPlainOnly,4,8,5,11,12,16,57.3594000115385,2.75,157.73835003173087,8.763241668429494,0.009731286848828622,1,0
StringDecoder.java,allMimeTypes,1,4,1,5,5,6,13.931568569324174,0.625,8.707230355827608,0.48373501976820044,0.0014107999471601703,1,0
StringDecoder.java,allMimeTypes,5,10,6,13,15,19,74.23092131656186,3.25,241.25049427882604,13.402805237712558,0.012917869310319184,1,0
StompHeaderAccessor.java,create,2,5,2,7,7,9,25.26619429851844,1.4,35.372672017925815,1.965148445440323,0.0035918979562143964,2,0
StompHeaderAccessor.java,create,4,9,6,13,13,19,70.30835464468075,2.888888888888889,203.1130245290777,11.284056918282095,0.01151782814160799,3,0
StompHeaderAccessor.java,createForHeartbeat,2,3,2,4,5,6,13.931568569324174,1.3333333333333333,18.575424759098897,1.0319680421721609,0.002337964509447503,1,0
StompHeaderAccessor.java,wrap,13,43,70,105,56,175,1016.2871113600806,15.872093023255813,16130.603569843139,896.1446427690632,0.21280369144537295,8,0
StompHeaderAccessor.java,getCommand,12,65,51,135,77,186,1165.6222965692516,12.461538461538463,14525.447080324522,806.9692822402512,0.19844115719323546,6,0
StompHeaderAccessor.java,getContentLength,10,48,33,110,58,143,837.6912823032428,11.458333333333332,9598.54594305799,533.2525523921106,0.15055056068191194,4,0
StompHeaderAccessor.java,getPasscode,7,35,16,79,42,95,512.2701551639823,7.9,4046.9342257954604,224.8296792108589,0.08465049640540018,1,0
MockitoUtils.java,verifySameInvocations,5,13,15,26,18,41,170.9669250591348,5.0,854.8346252956741,47.49081251642634,0.030023879979710306,2,0
MockitoUtils.java,verifySameInvocation,3,19,17,51,22,68,303.2413500673362,4.026315789473684,1220.9454357974325,67.83030198874626,0.03807818583836002,3,0
BeanUtils.java,findMethod,7,11,14,18,18,32,133.437600046154,5.7272727272727275,764.2335275370638,42.45741819650354,0.027863102314000632,3,0
BeanUtils.java,findDeclaredMethod,14,27,70,111,41,181,969.7169128358731,28.777777777777775,27906.297824943456,1550.3498791635254,0.3066763095968079,20,0
BeanUtils.java,resolveSignature,14,48,96,132,62,228,1357.5567587682074,19.25,26132.96760628799,1451.8315336826663,0.2935426645017514,26,0
BeanUtils.java,findEditorByConvention,12,39,72,94,51,166,941.6226067672682,14.46153846153846,13617.311544018954,756.517308001053,0.19008141707055196,18,0
BeanUtils.java,getWriteMethodParameter,4,6,7,13,10,20,66.43856189774725,4.333333333333333,287.90043489023805,15.994468605013225,0.014533614145669017,4,0
BeanUtils.java,isSimpleProperty,7,8,9,13,15,22,85.95159310338741,5.6875,488.84968577551587,27.158315876417547,0.02068532294082573,2,0
BeanUtils.java,isSimpleValueType,15,58,102,177,73,279,1726.961051927525,22.88793103448276,39526.56545575499,2195.9203030974995,0.3867866400674937,13,0
MetadataReaderFactory.java,create,2,6,2,8,8,10,30.0,1.3333333333333333,40.0,2.2222222222222223,0.003898690317617154,2,0
MetadataReaderFactory.java,create,2,6,2,8,8,10,30.0,1.3333333333333333,40.0,2.2222222222222223,0.003898690317617154,1,0
ReactiveTypeDescriptor.java,multiValue,5,8,8,12,13,20,74.00879436282185,3.75,277.5329788605819,15.418498825587884,0.014182576779876119,2,0
ReactiveTypeDescriptor.java,singleOptionalValue,5,8,8,12,13,20,74.00879436282185,3.75,277.5329788605819,15.418498825587884,0.014182576779876119,2,0
ReactiveTypeDescriptor.java,singleRequiredValue,5,6,5,10,11,15,51.89147427955946,4.166666666666667,216.2144761648311,12.011915342490617,0.0120079422476533,2,0
ReactiveTypeDescriptor.java,noValue,5,8,8,12,13,20,74.00879436282185,3.75,277.5329788605819,15.418498825587884,0.014182576779876119,1,0
ScenariosForSpringSecurity.java,hasRole,6,21,12,24,27,36,171.17595007788486,3.4285714285714284,586.8889716956052,32.60494287197807,0.023365910620090014,2,0
JsonObjectDecoderTests.java,toString,4,10,7,16,14,23,87.56916320732489,3.2,280.2213222634397,15.56785123685776,0.014274016593709563,1,0
RSocketMessageHandlerTests.java,testMapping,7,49,47,90,56,137,795.6076243218918,6.428571428571429,5114.620442069305,284.1455801149614,0.0989511893652593,3,0
RSocketMessageHandlerTests.java,testHandleNoMatch,5,40,25,58,45,83,455.823806995363,3.625,1652.3613003581909,91.7978500198995,0.04658886052318751,1,0
ExceptionHandlerExceptionResolverTests.java,setupOnce,9,203,654,1308,212,1962,15162.179931852996,28.995073891625616,439628.52748220065,24423.80708234448,1.9272408360461657,2,0
TransportType.java,fromValue,2,9,4,12,11,16,55.35090589819676,1.3333333333333333,73.80120786426234,4.1000671035701295,0.005864816006249215,1,0
FreePortScanner.java,getFreePort,1,3,1,4,4,5,10.0,0.6666666666666666,6.666666666666666,0.37037037037037035,0.0011807317435362345,1,0
FreePortScanner.java,getFreePort,9,13,16,29,22,45,200.67442283867837,10.038461538461538,2014.4624754190404,111.91458196772447,0.053168148048076666,3,0
FreePortScanner.java,getRandomPort,3,5,3,7,8,10,30.0,2.0999999999999996,62.999999999999986,3.499999999999999,0.0052776320879040755,1,0
FreePortScanner.java,isPortAvailable,8,13,17,25,21,42,184.47733175670794,7.6923076923076925,1419.0563981285227,78.8364665626957,0.04209319094072003,4,0
JdbcTemplate.java,getSql,6,11,9,21,17,30,122.62388523751017,5.7272727272727275,702.3004336330127,39.0166907573896,0.026336660354818364,2,0
JdbcTemplate.java,updateCount,14,86,118,236,100,354,2351.9250911802524,19.209302325581394,45178.84012360205,2509.9355624223363,0.42283292425405006,17,0
BridgeMethodResolver.java,findBridgedMethod,9,19,25,42,28,67,322.09277977785945,9.947368421052632,3203.975546211339,177.9986414561855,0.07244440899510145,11,0
BridgeMethodResolver.java,isBridgedCandidateFor,5,9,17,21,14,38,144.67948703818897,5.833333333333334,843.9636743894357,46.886870799413096,0.029768794504196606,3,0
BridgeMethodResolver.java,searchCandidates,8,17,18,40,25,58,269.343659006934,9.411764705882353,2534.999143594673,140.83328575525962,0.06197225367213943,6,0
BridgeMethodResolver.java,isBridgeMethodFor,7,11,8,22,18,30,125.09775004326937,7.0,875.6842503028856,48.64912501682698,0.030510109836315212,4,0
BridgeMethodResolver.java,findGenericDeclaration,6,17,26,47,23,73,330.22002279216196,8.294117647058822,2738.883718452637,152.16020658070204,0.06525209725746202,7,0
BridgeMethodResolver.java,isResolvedTypeMatch,9,24,33,53,33,86,433.817894264827,9.9375,4311.065324256718,239.5036291253732,0.08829480417702608,6,0
BridgeMethodResolver.java,searchForMatch,2,9,4,13,11,17,58.81033751683405,1.4444444444444444,84.94826530209363,4.719348072338535,0.006441422042478048,2,0
BridgeMethodResolver.java,isVisibilityBridgeMethodPair,4,9,11,19,13,30,111.01319154423277,4.222222222222222,468.7223642978717,26.04013134988176,0.020113571594418,2,0
ExpressionLanguageScenarioTests.java,repeat,11,69,112,275,80,387,2446.586172721409,21.920289855072465,53629.87806146567,2979.4376700814264,0.47404177790355984,7,0
FactoryMethodTests.java,getDefaultInstance,4,12,7,19,16,26,104.0,3.1666666666666665,329.3333333333333,18.296296296296294,0.015896537486793382,1,0
StandardJUnit4FeaturesTests.java,incrementStaticBeforeCounter,6,29,19,43,35,62,318.01554705058794,4.448275862068966,1414.620881707788,78.590048983766,0.04200543194885183,2,0
LocalVariableTableParameterNameDiscoverer.java,isSyntheticOrBridged,5,5,7,8,10,15,49.82892142331043,4.0,199.31568569324173,11.073093649624541,0.011373821215187386,1,0
LocalVariableTableParameterNameDiscoverer.java,isStatic,14,60,115,186,74,301,1869.045463054314,21.7,40558.286548278615,2253.2381415710342,0.39348828901600436,13,0
LocalVariableTableParameterNameDiscoverer.java,isWideType,4,5,8,9,9,17,53.8887250245193,3.6,193.99941008826949,10.77774500490386,0.011170664751340511,1,0
ReflectionTestUtilsTests.java,assertSetFieldAndGetFieldBehavior,1,21,29,79,22,108,481.6186148128281,1.880952380952381,905.9016802431767,50.32787112462093,0.031208013276772088,1,0
ReflectionTestUtilsTests.java,assertSetFieldAndGetFieldBehaviorForProxy,8,101,301,686,109,987,6680.197928554826,27.168316831683168,181489.73382133112,10082.76299007395,1.0685137644903104,7,0
DefaultMessageCodesResolver.java,toDelimitedString,5,12,14,23,17,37,151.23612512626255,4.791666666666667,724.6730995633415,40.259616642407856,0.026893056985797546,3,0
ScriptFactoryPostProcessorTests.java,createScriptFactoryPostProcessor,4,10,7,14,14,21,79.9544533632097,2.8,223.87246941698714,12.43735941205484,0.01228982989442308,2,0
ScriptFactoryPostProcessorTests.java,createScriptedGroovyBean,4,11,16,15,15,31,121.11360846386408,2.727272727272727,330.30984126508383,18.350546736949102,0.015927945247455878,1,0
ScriptFactoryPostProcessorTests.java,pauseToLetRefreshDelayKickIn,6,13,9,21,19,30,127.43782540330756,4.846153846153847,617.5833077237213,34.31018376242896,0.024173661961815262,2,0
TransactionAspectUtils.java,getTransactionManager,2,8,3,11,10,14,46.50699332842307,1.375,63.94711582658172,3.5526175459212066,0.005330394918929973,3,0
TransactionAspectUtils.java,getTransactionManager,2,8,3,11,10,14,46.50699332842307,1.375,63.94711582658172,3.5526175459212066,0.005330394918929973,1,0
LogDelegateFactory.java,getCompositeLog,7,13,16,26,20,42,181.52097998526924,7.0,1270.6468598968847,70.59149221649359,0.03910467285422459,2,0
LogDelegateFactory.java,getHiddenLog,6,7,7,8,13,15,55.506595772116384,3.4285714285714284,190.30832836154187,10.572684908974548,0.011028521011640958,1,0
RequestResultMatchers.java,assertAsyncStarted,1,5,1,6,6,7,18.094737505048094,0.6,10.856842503028856,0.6031579168349365,0.001634360172194361,1,0
BenchmarkTests.java,advisor,10,32,22,42,42,64,345.1083150578407,6.5625,2264.7733175670796,125.82073986483776,0.05748597545413686,1,0
BenchmarkTests.java,advisor,6,14,11,15,20,26,112.37013046707143,3.2142857142857144,361.1897050727296,20.066094726262758,0.01690579716709622,1,0
AutowireUtils.java,sortConstructors,4,6,4,7,10,11,36.541209043760986,2.3333333333333335,85.26282110210897,4.736823394561609,0.006457313583410306,1,0
AutowireUtils.java,sortFactoryMethods,1,6,1,7,7,8,22.458839376460833,0.5833333333333334,13.100989636268821,0.72783275757049,0.0018524570494490341,1,0
AutowireUtils.java,isExcludedFromDependencyCheck,7,16,19,24,23,43,194.51316411045156,5.25,1021.1941115798707,56.733006198881704,0.03380266540268956,4,0
AutowireUtils.java,isSetterDefinedInInterface,8,18,21,28,26,49,230.3215461889135,6.222222222222222,1433.1118429532396,79.61732460851331,0.04237068337544571,4,0
AutowireUtils.java,resolveAutowiringValue,16,82,151,230,98,381,2520.204450607894,22.4390243902439,56550.92913559177,3141.7182853106538,0.4911022326036034,40,0
ContentDisposition.java,builder,2,5,2,6,7,8,22.458839376460833,1.2,26.950607251753,1.4972559584307221,0.002996340161479074,1,0
ContentDisposition.java,empty,2,3,2,10,5,12,27.863137138648348,3.3333333333333335,92.8771237954945,5.159840210860805,0.00683624969693664,1,0
ContentDisposition.java,parse,16,57,145,223,73,368,2277.8554376678467,31.29824561403509,71292.87896139365,3960.715497855203,0.5731164144921351,23,0
ContentDisposition.java,decodeFilename,12,26,38,62,38,100,524.7927513443585,14.307692307692307,7508.57321154236,417.14295619679774,0.1278155495747519,5,0
ContentDisposition.java,isRFC5987AttrChar,14,8,62,26,22,88,392.42998244008214,22.75,8927.78210051187,495.98789447288164,0.14345239385383673,1,0
ContentDisposition.java,escapeQuotationsInFilename,7,14,27,31,21,58,254.75441052116813,7.75,1974.346681539053,109.6859267521696,0.05245992773790602,4,0
ContentDisposition.java,encodeFilename,10,49,76,241,59,317,1864.7978466477039,24.591836734693878,45858.80418796904,2547.711343776058,0.4270649168916172,5,0
TestCompiler.java,forSystem,2,5,2,5,7,7,19.651484454403228,1.0,19.651484454403228,1.0917491363557348,0.00242740543524258,1,0
TestCompiler.java,forCompiler,15,115,266,478,130,744,5224.64165289317,31.17391304347826,162872.52457062624,9048.473587257013,0.9941317952354876,14,0
DefaultParts.java,formFieldPart,3,9,4,15,12,19,68.11428751370197,2.5,170.28571878425493,9.460317710236385,0.010240729541120035,2,0
DefaultParts.java,part,5,11,6,17,16,23,92.0,3.8636363636363633,355.45454545454544,19.747474747474747,0.01672636078081041,3,0
DefaultParts.java,part,3,12,5,22,15,27,105.48604608143,2.75,290.0866267239325,16.11592370688514,0.014607096011256867,1,0
DefaultParts.java,partInternal,12,78,168,331,90,499,3239.4346950685076,25.46153846153846,82480.99108212892,4582.277282340496,0.631608538478717,6,0
DefaultPathContainer.java,createFromUrlPath,12,32,48,73,44,121,660.591225855113,13.6875,9041.842403891858,502.32457799399214,0.14467162758489552,7,0
DefaultPathContainer.java,decodeAndParsePathSegment,10,28,46,86,38,132,692.7264317745532,15.357142857142858,10638.298773680639,591.0165985378133,0.16123532626240283,4,0
DefaultPathContainer.java,parsePathParamValues,7,18,23,58,25,81,376.1523513717527,11.277777777777779,4242.162629359211,235.67570163106726,0.08735148405501215,6,0
DefaultPathContainer.java,subPath,9,39,69,105,48,174,971.7834751254811,12.115384615384617,11773.530564020253,654.0850313344586,0.17251090585493856,4,0
DefaultPathContainer.java,from,4,10,8,22,14,30,114.22064766172812,4.4,502.5708497116038,27.920602761755767,0.021070601904317903,2,0
DefaultPathContainer.java,from,2,6,2,10,8,12,36.0,1.6666666666666667,60.0,3.3333333333333335,0.005108729549290353,2,0
DefaultPathContainer.java,from,9,23,40,82,32,122,610.0,16.043478260869563,9786.521739130434,543.695652173913,0.15250976623025145,3,0
ServerCodecConfigurer.java,create,5,13,9,15,18,24,100.07820003461549,2.884615384615384,288.6871154844677,16.03817308247043,0.014560077256449627,8,0
ForwardedHeaderFilter.java,getForwardedPrefix,10,60,67,145,70,212,1299.4079995923328,12.083333333333332,15701.179995074019,872.2877775041121,0.20900993978654772,7,0
PeriodicTriggerTests.java,assertNegligibleDifference,1,10,3,14,11,17,58.81033751683405,0.7,41.167236261783835,2.2870686812102132,0.0039741710298734564,1,0
PeriodicTriggerTests.java,assertApproximateDifference,4,14,12,25,18,37,154.28722505336555,3.5714285714285716,551.0258037620198,30.612544653445543,0.022404058763034414,1,0
PeriodicTriggerTests.java,context,2,9,2,19,11,21,72.64806399138324,2.111111111111111,153.36813509292017,8.520451949606676,0.009550706588095462,1,0
PeriodicTriggerTests.java,toInstant,7,27,28,73,34,101,513.8337469662843,9.462962962962964,4862.389716662431,270.13276203680175,0.0956706199279386,4,0
HttpServiceProxyFactory.java,builderFor,3,4,3,7,7,10,28.07354922057604,2.625,73.69306670401211,4.0940592613340065,0.005859085449651798,1,0
HttpServiceProxyFactory.java,builder,12,90,128,258,102,386,2575.556182000997,17.2,44299.56633041715,2461.087018356508,0.41732883703997814,7,0
ServletAnnotationControllerHandlerMethodTests.java,DataRecord,3,11,8,19,14,27,102.79858289555531,2.590909090909091,266.341782956666,14.796765719814779,0.013798703422966413,1,0
TransactionalApplicationListenerAdapterTests.java,runInTransaction,5,18,15,28,23,43,194.51316411045156,3.888888888888889,756.440082651756,42.024449036208665,0.02767335201811332,1,0
HttpLogging.java,forLogName,6,8,6,11,14,17,64.72503367497927,4.125,266.9907639092895,14.83282021718275,0.013821109377678928,2,0
HttpLogging.java,forLog,2,6,2,8,8,10,30.0,1.3333333333333333,40.0,2.2222222222222223,0.003898690317617154,1,0
ExtendedEntityManagerCreator.java,createApplicationManagedEntityManager,1,7,1,11,8,12,36.0,0.7857142857142857,28.285714285714285,1.5714285714285714,0.003094497803609548,1,0
ExtendedEntityManagerCreator.java,createApplicationManagedEntityManager,1,8,1,12,9,13,41.209025018750054,0.75,30.90676876406254,1.7170427091145857,0.0032828256182083743,1,0
ExtendedEntityManagerCreator.java,createContainerManagedEntityManager,1,7,1,11,8,12,36.0,0.7857142857142857,28.285714285714285,1.5714285714285714,0.003094497803609548,1,0
ExtendedEntityManagerCreator.java,createContainerManagedEntityManager,1,6,1,8,7,9,25.26619429851844,0.6666666666666666,16.844129532345626,0.9357849740192015,0.0021903379454711043,1,0
ExtendedEntityManagerCreator.java,createContainerManagedEntityManager,4,8,5,11,12,16,57.3594000115385,2.75,157.73835003173087,8.763241668429494,0.009731286848828622,1,0
ExtendedEntityManagerCreator.java,createContainerManagedEntityManager,8,20,17,45,28,62,298.0560051675714,9.0,2682.504046508143,149.0280025837857,0.06435352428527023,2,0
ExtendedEntityManagerCreator.java,createProxy,5,23,15,38,28,53,254.78981086905299,4.130434782608695,1052.3926970678274,58.466260948212636,0.03448767858852238,4,0
ExtendedEntityManagerCreator.java,createProxy,16,117,216,380,133,596,4204.9483315587095,25.982905982905983,109256.77716186733,6069.8209534370735,0.7618059067576102,39,0
CountingFactory.java,reset,1,2,1,2,3,3,4.754887502163468,0.5,2.377443751081734,0.13208020839342968,0.000593770903833207,1,0
CountingFactory.java,getFactoryBeanInstanceCount,6,17,12,21,23,33,149.27754454988144,3.7058823529411766,553.205018037796,30.73361211321089,0.022463089416418506,2,0
ClassUtils.java,registerCommonClasses,4,8,11,12,12,23,82.45413751658658,3.0,247.36241254975977,13.74235625276443,0.013135135298515907,8,0
ClassUtils.java,getDefaultClassLoader,5,13,18,25,18,43,179.30677506201943,4.8076923076923075,862.0518031827856,47.89176684348809,0.03019263302048661,9,0
ClassUtils.java,overrideThreadContextClassLoader,15,57,118,179,72,297,1832.4677254283667,23.55263157894737,43159.43721732601,2397.7465120736674,0.41013729297369766,31,0
ClassUtils.java,isPresent,7,15,11,20,22,31,138.24238017775622,4.666666666666666,645.1311074961956,35.84061708312198,0.024887278112137062,4,0
ClassUtils.java,isVisible,8,12,13,18,20,31,133.97977094150824,6.0,803.8786256490494,44.65992364716941,0.02881856817728402,5,0
ClassUtils.java,isCacheSafe,11,18,33,47,29,80,388.63847961020576,14.36111111111111,5581.2803877354545,310.0711326519697,0.1048820834294302,12,0
ClassUtils.java,isLoadable,10,19,26,31,29,57,276.9049167222716,8.157894736842104,2258.9611627343206,125.49784237412892,0.057387581364706446,9,0
ClassUtils.java,isPrimitiveWrapper,5,7,6,9,12,15,53.77443751081734,3.2142857142857144,172.84640628477004,9.602578126931668,0.010343137897991732,4,0
ClassUtils.java,isPrimitiveOrWrapper,6,7,7,10,13,17,62.907475208398566,4.285714285714286,269.60346517885097,14.977970287713942,0.013911129445930545,2,0
ClassUtils.java,isPrimitiveArray,6,8,9,11,14,20,76.14709844115208,4.125,314.10678106975234,17.450376726097353,0.015402703430761836,2,0
ClassUtils.java,isPrimitiveWrapperArray,7,13,22,26,20,48,207.45254855459342,7.0,1452.1678398821539,80.6759911045641,0.04274545605426239,5,0
ClassUtils.java,isVoidType,7,5,11,7,12,18,64.5293250129808,4.8999999999999995,316.1936925636059,17.56631625353366,0.015470851358978372,3,0
ClassUtils.java,isSimpleValueType,9,23,66,55,32,121,605.0,10.76086956521739,6510.326086956521,361.6847826086956,0.11621992028378658,3,0
ClassUtils.java,isAssignable,8,15,28,34,23,62,280.4608412755348,9.066666666666666,2542.844960898182,141.26916449434344,0.06210005713799017,5,0
ClassUtils.java,isAssignableValue,7,12,10,17,19,27,114.6940428629768,4.958333333333334,568.6912958622601,31.59396088123667,0.02288037471801246,1,0
ClassUtils.java,convertResourcePathToClassName,2,8,3,11,10,14,46.50699332842307,1.375,63.94711582658172,3.5526175459212066,0.005330394918929973,1,0
ClassUtils.java,convertClassNameToResourcePath,2,8,3,11,10,14,46.50699332842307,1.375,63.94711582658172,3.5526175459212066,0.005330394918929973,5,0
ClassUtils.java,addResourcePathToPackagePath,7,10,11,18,17,29,118.53642239625984,6.3,746.779461096437,41.48774783869094,0.027437233665208637,2,0
ClassUtils.java,classPackageAsResourcePath,7,15,18,25,22,43,191.75555960140377,5.833333333333334,1118.5740976748555,62.14300542638086,0.03591880814496751,3,0
ClassUtils.java,classNamesToString,5,6,8,8,11,16,55.35090589819676,3.333333333333333,184.50301966065584,10.250167758925324,0.010803083450376212,1,0
ClassUtils.java,classNamesToString,11,52,149,179,63,328,1960.5478149079727,18.93269230769231,37118.44853417114,2062.1360296761745,0.37091291504364227,25,0
ClassUtils.java,isJavaLanguageInterface,5,5,5,6,10,11,36.541209043760986,3.0,109.62362713128296,6.090201507293497,0.007635102239890672,3,0
ClassUtils.java,isStaticClass,5,6,6,7,11,13,44.97261104228487,2.916666666666667,131.17011553999754,7.287228641110975,0.008605352784528439,3,0
ClassUtils.java,isInnerClass,7,5,7,7,12,14,50.18947501009619,4.8999999999999995,245.9284275494713,13.662690419415073,0.01308432231664305,4,0
ClassUtils.java,isLambdaClass,7,11,17,15,18,32,133.437600046154,4.7727272727272725,636.8612729475531,35.381181830419614,0.02467413703165384,2,0
ClassUtils.java,isCglibProxy,2,6,2,7,8,9,27.0,1.1666666666666667,31.500000000000004,1.7500000000000002,0.0033246998805754875,2,0
ClassUtils.java,isCglibProxyClass,7,8,7,10,15,17,66.41714012534482,4.375,290.57498804838355,16.143054891576863,0.014623485461944925,2,0
ClassUtils.java,isCglibProxyClassName,8,18,29,38,26,67,314.92946111545314,8.444444444444445,2659.404338308271,147.7446854615706,0.0639835492374362,10,0
ClassUtils.java,getDescriptiveType,8,19,24,35,27,59,280.53836262764463,7.368421052631579,2067.124777256329,114.84026540312938,0.05409077538166474,4,0
ClassUtils.java,matchesTypeName,8,10,11,16,18,27,112.58797503894243,6.4,720.5630402492316,40.0312800138462,0.02679127609910761,3,0
ClassUtils.java,getShortName,5,16,16,31,21,47,206.43891887060175,4.84375,999.9385132794772,55.552139626637626,0.03333196694776348,3,0
ClassUtils.java,getShortName,4,5,4,7,9,11,34.86917501586544,2.8,97.63369004442322,5.424093891356845,0.0070677071743472505,2,0
ClassUtils.java,getShortNameAsProperty,9,12,14,21,21,35,153.73110979725664,7.875,1210.632489653396,67.25736053629979,0.037863459781371206,2,0
ClassUtils.java,getClassFileName,7,13,12,19,20,31,133.97977094150824,5.115384615384615,685.3580590469459,38.075447724830326,0.02591137310692985,4,0
ClassUtils.java,getPackageName,5,7,6,10,12,16,57.3594000115385,3.5714285714285716,204.85500004120894,11.380833335622718,0.011583588586351286,4,0
ClassUtils.java,getPackageName,6,9,8,15,15,23,89.85848369899593,5.0,449.29241849497964,24.960689916387757,0.019553813654773627,2,0
ClassUtils.java,getQualifiedName,5,7,6,9,12,15,53.77443751081734,3.2142857142857144,172.84640628477004,9.602578126931668,0.010343137897991732,1,0
ClassUtils.java,getQualifiedMethodName,1,5,1,7,6,8,20.67970000576925,0.7,14.475790004038473,0.8042105557799152,0.00197988634999937,1,0
ClassUtils.java,getQualifiedMethodName,7,12,13,18,19,31,131.68575291675114,5.25,691.3502028129435,38.40834460071908,0.02606218410446326,1,0
ClassUtils.java,hasConstructor,8,14,29,28,22,57,254.18760226232595,8.0,2033.5008180986076,112.97226767214487,0.05350261135602464,5,0
ClassUtils.java,hasMethod,7,16,18,28,23,46,208.0838499786226,6.125,1274.5135811190635,70.8063100621702,0.039183965948581694,2,0
ClassUtils.java,hasMethod,6,8,11,12,14,23,87.56916320732489,4.5,394.061234432962,21.892290801831223,0.017916556945966562,5,0
ClassUtils.java,getMethod,12,22,43,47,34,90,457.8716557125305,12.818181818181817,5869.082132315163,326.0601184619535,0.10845732031907279,9,0
ClassUtils.java,getMethodIfAvailable,7,18,23,33,25,56,260.05594662738457,6.416666666666666,1668.6923241923841,92.70512912179912,0.04689532940182985,4,0
ClassUtils.java,getMethodCountForName,8,19,28,44,27,72,342.3519001557697,9.263157894736842,3171.2597067060774,176.1810948170043,0.07195041197498417,5,0
ClassUtils.java,hasAtLeastOneMethodWithName,8,19,24,41,27,65,309.0676876406254,8.631578947368421,2667.742145950662,148.20789699725898,0.06411721429468774,13,0
ClassUtils.java,getMostSpecificMethod,12,23,31,49,35,80,410.3426413555973,12.782608695652176,5245.249415588941,291.4027453104967,0.10062892687395635,9,0
ClassUtils.java,getInterfaceMethodIfPossible,1,4,1,7,5,8,18.575424759098897,0.875,16.253496664211536,0.9029720369006409,0.002138831719813076,6,0
ClassUtils.java,getInterfaceMethodIfPossible,4,7,4,11,11,15,51.89147427955946,3.142857142857143,163.08749059290116,9.060416144050064,0.009950063342914196,1,0
ClassUtils.java,getInterfaceMethodIfPossible,11,28,43,67,39,110,581.3942440748474,13.160714285714285,7651.563533627902,425.08686297932786,0.12943315508748732,4,0
ClassUtils.java,findInterfaceMethodIfPossible,12,20,31,37,32,68,340.0,11.100000000000001,3774.0000000000005,209.66666666666669,0.08080036869855393,16,0
ClassUtils.java,getPubliclyAccessibleMethodIfPossible,10,23,28,47,33,75,378.329558951884,10.217391304347828,3865.5411458127287,214.75228587848494,0.08210172441280827,4,0
ClassUtils.java,findPubliclyAccessibleMethodIfPossible,9,16,21,28,25,49,227.5489532989615,7.875,1791.9480072293218,99.55266706829565,0.04917703588308365,7,0
ClassUtils.java,isUserLevelMethod,5,8,8,12,13,20,74.00879436282185,3.75,277.5329788605819,15.418498825587884,0.014182576779876119,1,0
ClassUtils.java,isGroovyObjectMethod,2,6,4,7,8,11,33.0,1.1666666666666667,38.5,2.138888888888889,0.0038006035086747304,1,0
ClassUtils.java,isOverridable,9,15,17,23,24,40,183.39850002884623,6.9,1265.449650199039,70.30275834439107,0.03899796920610213,5,0
ClassUtils.java,getStaticMethod,8,18,20,30,26,50,235.02198590705459,6.666666666666667,1566.813239380364,87.04517996557577,0.04496661890863208,2,0
ClassUtils.java,getMethodOrNull,9,21,28,41,30,69,338.57545109698776,8.785714285714285,2974.6271774949637,165.25706541638687,0.06894462910883765,4,0
MvcUriComponentsBuilder.java,relativeTo,2,4,2,6,6,8,20.67970000576925,1.5,31.019550008653873,1.723308333814104,0.003290806962640765,3,0
MvcUriComponentsBuilder.java,fromController,4,5,4,7,9,11,34.86917501586544,2.8,97.63369004442322,5.424093891356845,0.0070677071743472505,5,0
MvcUriComponentsBuilder.java,fromController,6,13,9,25,19,34,144.4295354570819,5.769230769230769,833.2473199447032,46.29151777470574,0.02951626237869611,4,0
MvcUriComponentsBuilder.java,fromMethodName,6,13,8,19,19,27,114.6940428629768,4.384615384615384,502.8892648607444,27.938292492263578,0.021079500802971086,6,0
MvcUriComponentsBuilder.java,fromMethodName,6,13,8,21,19,29,123.18989788986397,4.846153846153847,596.997197466264,33.166510970348,0.023633439978409134,6,0
MvcUriComponentsBuilder.java,fromMethod,5,10,7,13,15,20,78.13781191217038,3.25,253.94788871455373,14.10821603969743,0.01336724217607629,5,0
MvcUriComponentsBuilder.java,fromMethod,6,13,10,20,19,30,127.43782540330756,4.615384615384616,588.1745787844965,32.676365488027585,0.02340002090367889,3,0
MvcUriComponentsBuilder.java,fromMethodCall,6,18,13,29,24,42,192.56842503028855,4.833333333333334,930.7473876463948,51.70818820257749,0.03177605383354012,4,0
MvcUriComponentsBuilder.java,fromMethodCall,6,25,25,52,31,77,381.4731158997894,6.24,2380.392243214686,132.244013511927,0.05942617299325332,12,0
MvcUriComponentsBuilder.java,fromMappingName,1,5,1,7,6,8,20.67970000576925,0.7,14.475790004038473,0.8042105557799152,0.00197988634999937,6,0
MvcUriComponentsBuilder.java,fromMappingName,10,49,62,111,59,173,1017.6972475395986,11.326530612244898,11526.979028254638,640.3877237919244,0.17009403380585295,16,0
MvcUriComponentsBuilder.java,fromMethodInternal,9,25,21,49,34,70,356.12239888752373,8.82,3140.9995581879593,174.49997545488662,0.07149198059633975,2,0
MvcUriComponentsBuilder.java,getBaseUrlToUse,4,8,6,11,12,17,60.94436251225965,2.75,167.59699690871403,9.310944272706335,0.01013264670209245,1,0
MvcUriComponentsBuilder.java,getPathPrefix,7,16,17,31,23,48,217.13097389073664,6.78125,1472.4194166965578,81.80107870536432,0.04314194980184182,5,0
MvcUriComponentsBuilder.java,getClassMapping,10,22,25,34,32,59,295.0,7.727272727272727,2279.5454545454545,126.64141414141415,0.05773567526957878,4,0
MvcUriComponentsBuilder.java,getMethodMapping,10,23,25,37,33,62,312.7524354002241,8.043478260869566,2515.617415175716,139.75652306531754,0.061655970807997486,4,0
MvcUriComponentsBuilder.java,getMethod,11,28,45,54,39,99,523.2548196673627,10.607142857142858,5550.2386229002395,308.3465901611244,0.1044928357829895,3,0
MvcUriComponentsBuilder.java,applyContributors,9,27,30,49,36,79,408.42407511394265,8.166666666666668,3335.463280097199,185.3035155609555,0.07441312122554847,3,0
MvcUriComponentsBuilder.java,getUriComponentsContributor,6,12,8,15,18,23,95.90827503317318,3.75,359.65603137439945,19.98089063191108,0.016857906617387335,3,0
MvcUriComponentsBuilder.java,getWebApplicationContext,12,102,178,302,114,480,3279.7872067990756,17.764705882352942,58264.45508548946,3236.9141714160814,0.5009732513177313,16,0
MvcUriComponentsBuilder.java,getPath,5,25,33,61,30,94,461.24771598720076,6.1,2813.6110675219243,156.31172597344025,0.06643365105834584,2,0
StreamUtils.java,emptyInput,2,4,2,4,6,6,15.509775004326936,1.0,15.509775004326936,0.861654166907052,0.0020730784816858556,1,0
StreamUtils.java,nonClosing,3,6,3,9,9,12,38.039100017307746,2.25,85.58797503894243,4.754887502163468,0.006473720020679235,1,0
StreamUtils.java,nonClosing,4,21,7,40,25,47,218.26124091941205,3.8095238095238093,831.4713939787125,46.192855221039586,0.02947430818058535,2,0
ResponseEntity.java,status,3,6,3,9,9,12,38.039100017307746,2.25,85.58797503894243,4.754887502163468,0.006473720020679235,1,0
ResponseEntity.java,status,2,3,2,5,5,7,16.253496664211536,1.6666666666666667,27.089161107019226,1.5049533948344014,0.0030066008967897778,1,0
ResponseEntity.java,ok,8,25,44,63,33,107,539.7501707713545,10.08,5440.681721375254,302.26009563195856,0.10311320650489288,7,0
ResponseEntity.java,created,2,7,3,9,9,12,38.039100017307746,1.2857142857142858,48.90741430796711,2.7170785726648394,0.0044578817795075335,1,0
ResponseEntity.java,accepted,5,8,7,10,13,17,62.907475208398566,3.125,196.5858600262455,10.92143666812475,0.011269732209158166,1,0
ResponseEntity.java,badRequest,5,8,7,10,13,17,62.907475208398566,3.125,196.5858600262455,10.92143666812475,0.011269732209158166,1,0
ResponseEntity.java,unprocessableEntity,2,5,2,5,7,7,19.651484454403228,1.0,19.651484454403228,1.0917491363557348,0.00242740543524258,1,0
ResponseEntity.java,internalServerError,8,66,107,278,74,385,2390.6395457671456,16.848484848484848,40278.65416504645,2237.7030091692473,0.3916775798053649,6,0
MergedAnnotationsTests.java,assertSynthesized,1,8,3,9,9,12,38.039100017307746,0.5625,21.396993759735608,1.188721875540867,0.0025690974927434526,1,0
MergedAnnotationsTests.java,assertNotSynthesized,1,8,3,9,9,12,38.039100017307746,0.5625,21.396993759735608,1.188721875540867,0.0025690974927434526,1,0
DefaultRestClient.java,getContentType,17,187,363,746,204,1109,8508.719704246389,33.90909090909091,288522.9499712639,16029.052776181326,1.4554556887334347,32,0
DefaultRestClient.java,serializeCookies,11,49,75,121,60,196,1157.7505567392698,13.581632653061224,15724.142765509878,873.563486972771,0.2092136730164738,9,0
DefaultRestClient.java,createResourceAccessException,14,106,228,431,120,659,4551.640902506014,28.462264150943398,129550.00568736457,7197.22253818692,0.8534348426199359,10,0
RSocketMessageHandler.java,clientResponder,9,24,28,43,33,71,358.15198247445016,8.0625,2887.6003587002547,160.42224215001414,0.06759327201265497,2,0
AnnotationAttributes.java,fromMap,6,7,9,15,13,24,88.81055323538621,6.428571428571429,570.9249850846256,31.718054726923647,0.02294024814850238,3,0
AopNamespaceUtils.java,registerAutoProxyCreatorIfNecessary,4,13,8,22,17,30,122.62388523751017,3.3846153846153846,415.03468849618827,23.057482694232682,0.018546772418731837,1,0
AopNamespaceUtils.java,registerAutoProxyCreatorIfNecessary,3,15,6,24,18,30,125.09775004326937,2.4000000000000004,300.23460010384656,16.679700005769252,0.014945802496242944,1,0
AopNamespaceUtils.java,registerAutoProxyCreatorIfNecessary,1,10,3,15,11,18,62.26976913547135,0.75,46.702326851603516,2.594573713977973,0.004322859209155187,1,0
AopNamespaceUtils.java,registerAspectJAutoProxyCreatorIfNecessary,4,13,8,22,17,30,122.62388523751017,3.3846153846153846,415.03468849618827,23.057482694232682,0.018546772418731837,1,0
AopNamespaceUtils.java,registerAspectJAnnotationAutoProxyCreatorIfNecessary,4,14,8,23,18,31,129.26767504471167,3.2857142857142856,424.7366465754812,23.59648036530451,0.018834693959152982,1,0
AopNamespaceUtils.java,registerAutoProxyCreatorIfNecessary,4,12,5,17,16,22,88.0,2.8333333333333335,249.33333333333334,13.851851851851853,0.013204814582682968,1,0
AopNamespaceUtils.java,forceAutoProxyCreatorToUseClassProxying,2,5,4,7,7,11,30.880904142633646,1.4,43.2332657996871,2.401848099982617,0.004106048806073602,1,0
AopNamespaceUtils.java,useClassProxyingIfNecessary,4,16,13,27,20,40,172.8771237954945,3.375,583.4602928097939,32.41446071165522,0.02327481739496877,4,0
AopNamespaceUtils.java,useClassProxyingIfNecessary,2,9,6,15,11,21,72.64806399138324,1.6666666666666667,121.0801066523054,6.7266725917947445,0.00815819237144079,3,0
AopNamespaceUtils.java,registerComponentIfNecessary,4,11,5,16,15,21,82.0447025077789,2.909090909090909,238.6754982044477,13.259749900247094,0.012825785441332527,2,0
ResourceHttpMessageConverter.java,loadFileTypeMapFromContextSupportModule,8,15,17,25,23,42,189.98960215439456,6.666666666666667,1266.597347695964,70.36651931644244,0.03902154507304054,6,0
ResourceHttpMessageConverter.java,getMediaType,4,14,9,22,18,31,129.26767504471167,3.142857142857143,406.2698358548081,22.570546436378226,0.018284726321521626,3,0
RequestMappingInfo.java,calculateHashCode,11,48,79,123,59,202,1188.293895971092,14.09375,16747.517096342577,930.4176164634765,0.21819545423013795,8,0
RequestMappingInfo.java,paths,11,95,362,686,106,1048,7050.860636382232,39.71578947368421,280030.4966428438,15557.249813491324,1.426753562765272,22,0
ErrorResponse.java,getDefaultDetailMessageCode,7,8,10,12,15,22,85.95159310338741,5.25,451.2458637927839,25.06921465515466,0.019610450383863158,3,0
ErrorResponse.java,getDefaultTitleMessageCode,6,5,6,6,11,12,41.51317942364757,3.5999999999999996,149.44744592513123,8.302635884729513,0.009387236153112292,3,0
ErrorResponse.java,createFor,5,23,12,43,28,55,264.4045207131682,4.673913043478261,1235.803738115895,68.65576322866083,0.03838649108290825,3,0
DefaultConversionServiceTests.java,findTestEntity,7,16,20,26,23,46,208.0838499786226,5.6875,1183.476896753416,65.74871648630089,0.037295113638777695,1,0
DefaultConversionServiceTests.java,reset,6,18,21,39,24,60,275.09775004326934,6.5,1788.1353752812506,99.34085418229171,0.049107256891313684,2,0
DefaultConversionServiceTests.java,reset,6,18,19,37,24,56,256.75790004038475,6.166666666666666,1583.3403835823724,87.96335464346514,0.04528227846526794,2,0
DefaultConversionServiceTests.java,valueOf,3,5,4,7,8,11,33.0,2.0999999999999996,69.29999999999998,3.849999999999999,0.00562385655770182,1,0
DefaultPartHttpMessageReaderTests.java,testBrowserFormField,2,11,7,25,13,32,118.41407098051495,2.272727272727273,269.12288859207945,14.951271588448858,0.01389459318263815,1,0
DefaultPartHttpMessageReaderTests.java,testBrowserFile,9,29,26,52,38,78,409.33834604859965,8.068965517241379,3302.936999150769,183.4964999528205,0.07392856424536667,2,0
DefaultPartHttpMessageReaderTests.java,verifyContents,9,53,29,84,62,113,672.8241830737169,7.132075471698114,4798.632852865378,266.5907140480765,0.09483247690729998,2,0
ExceptionWebSocketHandlerDecorator.java,tryCloseWithError,7,23,24,67,30,91,446.5270442003752,10.195652173913043,4552.634428912521,252.9241349395845,0.09156312311166873,8,0
BeanDefinitionMethodGenerator.java,lookupGeneratedClass,7,27,30,58,34,88,447.6967300300298,7.518518518518519,3366.016155410965,187.0008975228314,0.07486684688941997,4,0
BeanDefinitionMethodGenerator.java,createInnerClass,13,96,142,266,109,408,2761.419204508986,18.010416666666668,49734.310464542046,2763.0172480301135,0.45079886370005945,14,0
StompHeaders.java,readOnlyStompHeaders,7,11,9,15,18,24,100.07820003461549,4.7727272727272725,477.6459547106648,26.535886372814712,0.02036805135194445,1,0
SimpLogging.java,forLogName,6,8,6,11,14,17,64.72503367497927,4.125,266.9907639092895,14.83282021718275,0.013821109377678928,2,0
SimpLogging.java,forLog,2,6,2,8,8,10,30.0,1.3333333333333333,40.0,2.2222222222222223,0.003898690317617154,1,0
ApplicationManagedEntityManagerIntegrationTests.java,deleteAllPeopleUsingEntityManager,3,17,9,35,20,44,190.16483617504394,3.0882352941176467,587.273758775871,32.62631993199283,0.02337612256679133,1,0
RoutingFunctions.java,toHttpHandler,4,5,4,7,9,11,34.86917501586544,2.8,97.63369004442322,5.424093891356845,0.0070677071743472505,1,0
RoutingFunctions.java,toHttpHandler,8,23,24,38,31,62,307.16017124398627,6.608695652173913,2029.9280882211267,112.77378267895148,0.05343992589808128,1,0
RoutingFunctions.java,toHandlerMapping,4,5,4,7,9,11,34.86917501586544,2.8,97.63369004442322,5.424093891356845,0.0070677071743472505,1,0
RoutingFunctions.java,toHandlerMapping,8,19,20,31,27,51,242.49926261033687,6.526315789473684,1582.626766509567,87.9237092505315,0.04526867152170978,1,0
RoutingFunctions.java,defaultConfiguration,2,4,3,5,6,8,20.67970000576925,1.25,25.84962500721156,1.43609027817842,0.0029141701819800085,1,0
RoutingFunctions.java,addAttributes,5,17,12,23,22,35,156.0801066523054,3.382352941176471,527.9180077945624,29.328778210809023,0.02177324016146962,1,0
ClassUtilsTests.java,staticMethod,1,3,1,3,4,4,8.0,0.5,4.0,0.2222222222222222,0.0008399473665965822,1,0
ClassUtilsTests.java,staticMethod,1,5,1,5,6,6,15.509775004326936,0.5,7.754887502163468,0.430827083453526,0.0013059576085800565,1,0
ClassUtilsTests.java,argStaticMethod,1,13,1,29,14,30,114.22064766172812,1.1153846153846154,127.3999531611583,7.077775175619905,0.008439659478595866,1,0
ClassUtilsTests.java,assertIsLambda,3,9,5,10,12,15,53.77443751081734,1.6666666666666667,89.62406251802891,4.97911458433494,0.006675674651348494,1,0
ClassUtilsTests.java,assertIsNotLambda,5,11,15,16,16,31,124.0,3.6363636363636367,450.90909090909093,25.050505050505052,0.019600692082517957,1,0
ClassUtilsTests.java,staticStringFactory,3,10,8,19,13,27,99.91187238980949,2.8499999999999996,284.748836310957,15.819379795053168,0.014427354967881462,1,0
AnnotatedBeanDefinitionReader.java,getOrCreateEnvironment,5,10,10,13,15,23,89.85848369899593,3.25,292.04007202173676,16.224448445652044,0.014672598820854352,2,0
SocketUtils.java,findAvailableTcpPort,1,2,1,3,3,4,6.339850002884624,0.75,4.754887502163468,0.26416041678685936,0.0009425525573729414,2,0
SocketUtils.java,findAvailableTcpPort,1,3,1,5,4,6,12.0,0.8333333333333334,10.0,0.5555555555555556,0.0015471962778709262,2,0
SocketUtils.java,findAvailableTcpPort,4,13,11,28,17,39,159.41105080876324,4.3076923076923075,686.693757330057,38.14965318500317,0.025945028064340885,4,0
SocketUtils.java,findAvailableUdpPort,1,2,1,3,3,4,6.339850002884624,0.75,4.754887502163468,0.26416041678685936,0.0009425525573729414,2,0
SocketUtils.java,findAvailableUdpPort,1,3,1,5,4,6,12.0,0.8333333333333334,10.0,0.5555555555555556,0.0015471962778709262,2,0
SocketUtils.java,findAvailableUdpPort,14,50,91,166,64,257,1542.0,23.24,35836.079999999994,1990.893333333333,0.36232008556378204,17,0
HttpServiceMethod.java,create,7,25,18,47,32,65,325.0,6.58,2138.5,118.80555555555556,0.055328842113819866,1,0
HttpServiceMethod.java,initHttpMethod,7,15,14,32,22,46,205.13385445731566,7.466666666666667,1531.6661132812903,85.09256184896057,0.04429161144480261,3,0
HttpServiceMethod.java,initUrl,8,16,26,41,24,67,307.19248754831744,10.25,3148.722997370254,174.92905540945856,0.07160912757749333,3,0
HttpServiceMethod.java,initContentType,8,43,80,133,51,213,1208.2265978399284,12.372093023255815,14948.291861647487,830.4606589804159,0.20227387346651016,7,0
HttpServiceMethod.java,create,12,67,136,193,79,329,2073.943866150267,17.28358208955224,35845.17905973148,1991.398836651749,0.36238141356252,9,0
AnnotatedElementUtils.java,hasMetaAnnotationTypes,8,23,17,38,31,55,272.4807970712781,6.608695652173913,1800.742658905838,100.04125882810212,0.04933780762318321,3,0
AnnotatedElementUtils.java,isAnnotated,8,33,24,60,41,84,450.034368387919,7.2727272727272725,3272.977224639411,181.83206803552284,0.07348083240557018,3,0
AnnotatedElementUtils.java,getMergedAnnotationAttributes,5,12,6,16,17,22,89.92418250750745,3.333333333333333,299.7472750250248,16.652626390279156,0.014929625288694586,1,0
AnnotatedElementUtils.java,getAnnotationAttributes,1,7,1,9,8,10,30.0,0.6428571428571429,19.28571428571429,1.0714285714285716,0.0023971905901744215,3,0
AnnotatedElementUtils.java,getMergedAnnotationAttributes,1,8,1,12,9,13,41.209025018750054,0.75,30.90676876406254,1.7170427091145857,0.0032828256182083743,1,0
AnnotatedElementUtils.java,getAnnotationAttributes,1,9,1,13,10,14,46.50699332842307,0.7222222222222222,33.58838407052777,1.866021337251543,0.0034700693337677813,2,0
AnnotatedElementUtils.java,getMergedAnnotationAttributes,8,27,21,69,35,90,461.63547152504697,10.222222222222221,4718.940375589369,262.1633541994094,0.09377960632394952,5,0
AnnotatedElementUtils.java,findMergedAnnotationAttributes,16,120,324,720,136,1044,7399.311206265354,48.0,355166.937900737,19731.496550040945,1.671733707349012,67,0
PubSubHeaderAccesssor.java,create,3,5,3,7,8,10,30.0,2.0999999999999996,62.999999999999986,3.499999999999999,0.0052776320879040755,2,0
PubSubHeaderAccesssor.java,create,2,5,2,8,7,10,28.07354922057604,1.6,44.91767875292167,2.495426597384537,0.00421201861424495,1,0
PubSubHeaderAccesssor.java,wrap,11,59,102,194,70,296,1814.26777301571,18.084745762711865,32810.57142047055,1822.809523359475,0.3416289042209942,6,0
MessageHeaderAccessorTests.java,wrap,5,6,9,13,11,22,76.10749561002054,5.416666666666666,412.24893455427787,22.90271858634877,0.018463687449969336,1,0
FactoryMethods.java,nullInstance,1,3,1,3,4,4,8.0,0.5,4.0,0.2222222222222222,0.0008399473665965822,1,0
AnnotationAwareOrderComparator.java,sort,4,6,6,9,10,15,49.82892142331043,3.0,149.4867642699313,8.304820237218406,0.009388882548620756,3,0
AnnotationAwareOrderComparator.java,sort,2,6,3,9,8,12,36.0,1.5,54.0,3.0,0.004762203155904598,4,0
AnnotationAwareOrderComparator.java,sortIfNecessary,4,5,5,13,9,18,57.05865002596162,5.2,296.7049801350004,16.483610007500022,0.014828434479685034,3,0
MethodParameter.java,forMethodOrConstructor,5,8,10,19,13,29,107.31275182609167,5.9375,637.1694639674193,35.39830355374552,0.02468209662410386,3,0
LocalVariableTableParameterNameDiscovererTests.java,staticMethodNoLocalVars,0,1,0,1,1,1,0.0,0.0,0.0,0.0,0,1,0
LocalVariableTableParameterNameDiscovererTests.java,staticMethod,3,5,3,11,8,14,42.0,3.3000000000000003,138.60000000000002,7.700000000000001,0.008927315815814128,1,0
LocalVariableTableParameterNameDiscovererTests.java,staticMethod,5,20,20,61,25,81,376.1523513717527,7.625,2868.1616792096142,159.34231551164524,0.06728958212286686,1,0
LocalVariableTableParameterNameDiscovererTests.java,staticMethod,2,4,2,8,6,10,25.84962500721156,2.0,51.69925001442312,2.87218055635684,0.004625956812489424,1,0
LocalVariableTableParameterNameDiscovererTests.java,staticMethod,7,19,13,50,26,63,296.1277022428888,9.210526315789474,2727.491994342397,151.52733301902205,0.06507103806032594,1,0
LocalVariableTableParameterNameDiscovererTests.java,voidStaticMethod,0,6,0,6,6,6,15.509775004326936,0.0,0.0,0.0,0,1,0
LocalVariableTableParameterNameDiscovererTests.java,nonVoidStaticMethod,1,7,1,8,8,9,27.0,0.5714285714285714,15.428571428571427,0.8571428571428571,0.0020658362264359114,1,0
LocalVariableTableParameterNameDiscovererTests.java,getDate,1,3,1,3,4,4,8.0,0.5,4.0,0.2222222222222222,0.0008399473665965822,1,0
CallbacksSecurityTests.java,makeStaticInstance,2,7,4,14,9,18,57.05865002596162,2.0,114.11730005192324,6.339850002884624,0.007842353307870626,1,0
CallbacksSecurityTests.java,getCurrentSubjectName,11,130,239,464,141,703,5019.104600736352,19.630769230769232,98528.88416214747,5473.826897897082,0.7110843517350379,19,0
CharBufferDecoder.java,textPlainOnly,1,4,1,5,5,6,13.931568569324174,0.625,8.707230355827608,0.48373501976820044,0.0014107999471601703,2,0
CharBufferDecoder.java,textPlainOnly,5,10,6,14,15,20,78.13781191217038,3.5,273.4823416925963,15.193463427366462,0.014044240951426278,1,0
CharBufferDecoder.java,allMimeTypes,1,4,1,5,5,6,13.931568569324174,0.625,8.707230355827608,0.48373501976820044,0.0014107999471601703,1,0
CharBufferDecoder.java,allMimeTypes,6,12,7,16,18,23,95.90827503317318,4.0,383.63310013269273,21.312950007371818,0.01759905949713497,1,0
MimeType.java,valueOf,9,37,60,89,46,149,823.010731452495,10.824324324324323,8908.535079641195,494.91861553562194,0.14324614447753986,7,0
DefaultResponseBuilder.java,isEmptyCollection,14,86,141,258,100,399,2650.898619720115,21.0,55668.87101412242,3092.7150563401347,0.4859821907428967,3,0
ETag.java,quoteETagIfNecessary,4,11,13,23,15,36,140.64806144190666,4.181818181818182,588.164620575246,32.67581225418033,0.023399756783727008,5,0
DummyFactory.java,reset,5,36,36,92,41,128,685.7666565911147,6.388888888888888,4381.286972665454,243.40483181474747,0.08925102492878641,5,0
DummyFactory.java,wasPrototypeCreated,10,22,24,39,32,63,315.0,8.863636363636363,2792.0454545454545,155.11363636363637,0.06609375123409905,4,0
CacheAdviceParser.java,getAttributeValue,6,37,50,129,43,179,971.3013910916756,10.45945945945946,10159.287523039959,564.4048623911088,0.15635829032732892,10,0
SessionFactoryUtils.java,getDataSource,4,10,7,17,14,24,91.3765181293825,3.4,310.6801616399005,17.260008979994474,0.015290479103504414,6,0
SessionFactoryUtils.java,newJdbcExceptionTranslator,4,10,7,13,14,20,76.14709844115208,2.6,197.98245594699543,10.999025330388635,0.011323044570740444,5,0
SessionFactoryUtils.java,getJtaTransactionManager,14,72,138,305,86,443,2846.835286333029,29.652777777777775,84416.57411556967,4689.809673087204,0.6414516019320979,67,0
SessionFactoryUtils.java,registerJtaSynchronization,8,35,31,68,43,99,537.2002107155076,7.771428571428571,4174.813066131945,231.93405922955247,0.0864244785701446,11,0
SessionFactoryUtils.java,getNewSession,1,5,1,7,6,8,20.67970000576925,0.7,14.475790004038473,0.8042105557799152,0.00197988634999937,4,0
SessionFactoryUtils.java,getNewSession,10,20,25,43,30,68,333.66856050137926,10.75,3586.937025389827,199.2742791883237,0.07810783136310649,9,0
SessionFactoryUtils.java,toString,3,9,7,11,12,18,64.5293250129808,1.8333333333333335,118.30376252379816,6.5724312513221195,0.00803300030323929,3,0
SessionFactoryUtils.java,hasTransactionalSession,6,10,10,16,16,26,104.0,4.800000000000001,499.20000000000005,27.733333333333334,0.020976279591261516,2,0
SessionFactoryUtils.java,isSessionTransactional,5,12,9,19,17,28,114.4489595550095,3.958333333333333,453.02713157191255,25.168173976217364,0.019662023926898718,4,0
SessionFactoryUtils.java,applyTransactionTimeout,4,15,9,24,19,33,140.1816079436383,3.2,448.5811454196426,24.9211747455357,0.019533171161781063,5,0
SessionFactoryUtils.java,applyTransactionTimeout,4,15,8,22,19,30,127.43782540330756,2.933333333333333,373.8176211830355,20.76764562127975,0.01729757643198109,2,0
SessionFactoryUtils.java,convertHibernateAccessException,6,35,83,122,41,205,1098.2981609467072,10.457142857142857,11485.060768756995,638.0589315976108,0.16968141489543206,18,0
SessionFactoryUtils.java,isDeferredCloseActive,7,13,11,18,20,29,125.33591475173351,4.846153846153846,607.397125335324,33.74428474085133,0.023907118455260265,4,0
SessionFactoryUtils.java,initDeferredClose,5,18,21,30,23,51,230.70165975890765,4.166666666666667,961.2569156621153,53.40316198122863,0.03246671859753488,5,0
SessionFactoryUtils.java,processDeferredClose,9,21,23,37,30,60,294.41343573651113,7.928571428571429,2334.2779547680525,129.68210859822514,0.05865618201822945,6,0
SessionFactoryUtils.java,releaseSession,3,8,4,13,11,17,58.81033751683405,2.4375,143.350197697283,7.963899872071277,0.009130143625396785,4,0
SessionFactoryUtils.java,closeSessionOrRegisterDeferredClose,6,20,19,36,26,55,258.52418449776,5.4,1396.0305962879042,77.55725534932802,0.04163661068557013,4,0
SessionFactoryUtils.java,closeSession,4,10,8,19,14,27,102.79858289555531,3.8,390.6346150031102,21.701923055728344,0.017812541735332872,4,0
SpringProperties.java,setProperty,2,7,3,14,9,17,53.8887250245193,2.0,107.7774500490386,5.987636113835478,0.007549137715831633,4,0
SpringProperties.java,getProperty,6,11,14,23,17,37,151.23612512626255,6.2727272727272725,948.6629667011014,52.703498150061186,0.03218251967359553,5,0
SpringProperties.java,setFlag,1,8,3,9,9,12,38.039100017307746,0.5625,21.396993759735608,1.188721875540867,0.0025690974927434526,3,0
SpringProperties.java,getFlag,2,6,2,7,8,9,27.0,1.1666666666666667,31.500000000000004,1.7500000000000002,0.0033246998805754875,1,0
HttpServiceProxyRegistryFactoryBean.java,addGroupAdapter,12,110,300,430,122,730,5059.438256420907,23.454545454545453,118666.82455969036,6592.6013644272425,0.8049426874326037,3,0
XmlEventDecoderTests.java,assertStartElement,1,12,6,16,13,22,81.40967379910403,0.6666666666666666,54.27311586606935,3.015173103670519,0.004778246851306007,1,0
XmlEventDecoderTests.java,assertEndElement,2,13,8,18,15,26,101.57915548582149,1.3846153846153846,140.64806144190666,7.8137811912170365,0.009015045279478254,1,0
XmlEventDecoderTests.java,assertCharacters,6,28,21,41,34,62,315.42269615752105,4.392857142857142,1385.6068438348245,76.97815799082359,0.041429092966838714,1,0
FactoryMethodComponent.java,nullInstance,6,26,24,51,32,75,375.0,5.884615384615384,2206.730769230769,122.59615384615384,0.05649954872163508,1,0
TestPropertySourceAttributes.java,detectDefaultPropertiesFile,10,22,27,44,32,71,355.0,10.0,3550.0,197.22222222222223,0.07757068870639545,5,0
JdkClientHttpResponse.java,adaptHeaders,8,83,97,154,91,251,1633.4564546898728,7.421686746987952,12123.002121553754,673.5001178640974,0.1759079764404008,1,0
Netty4ClientHttpRequest.java,getPort,8,27,27,56,35,83,425.7304904064322,8.296296296296296,3531.986290779289,196.22146059884938,0.07730805579560046,4,0
AbstractUrlHandlerMapping.java,prependLeadingSlash,5,6,7,11,11,18,62.26976913547135,4.583333333333333,285.403108537577,15.85572825208761,0.014449446498593787,2,0
MergedContextConfiguration.java,nullSafeToString,11,44,127,201,55,328,1896.2859860360884,25.125,47644.18539915672,2646.89918884204,0.43807857717225407,22,0
JndiPropertySource.java,createDefaultJndiLocator,4,5,4,9,9,13,41.209025018750054,3.6,148.3524900675002,8.241805003750011,0.009341328368971053,1,0
ObjectToObjectConverter.java,hasConversionMethodOrConstructor,5,7,8,10,12,18,64.5293250129808,3.5714285714285716,230.46187504636003,12.803437502575557,0.012529819245962203,1,0
ObjectToObjectConverter.java,getValidatedExecutable,6,14,21,39,20,60,259.31568569324173,8.357142857142858,2167.1382304363774,120.39656835757653,0.05582171233032057,5,0
ObjectToObjectConverter.java,isApplicable,8,18,28,34,26,62,291.4272625247477,7.555555555555555,2201.8948724092047,122.32749291162249,0.05641697532638618,3,0
ObjectToObjectConverter.java,determineToMethod,11,17,28,32,28,60,288.44129532345625,10.352941176470589,2986.2157633487236,165.90087574159577,0.0691235765486218,2,0
ObjectToObjectConverter.java,determineFactoryMethod,8,12,25,37,20,62,267.95954188301647,12.333333333333334,3304.8343498905365,183.60190832725203,0.07395687339166972,5,0
ObjectToObjectConverter.java,areRelatedTypes,6,12,21,24,18,45,187.64662506490404,6.0,1125.8797503894243,62.548875021634686,0.036075034136337204,1,0
ContentNegotiatingViewResolver.java,loadFileTypeMapFromContextSupportModule,8,15,17,25,23,42,189.98960215439456,6.666666666666667,1266.597347695964,70.36651931644244,0.03902154507304054,6,0
ContentNegotiatingViewResolver.java,getMediaType,4,11,6,16,15,22,85.95159310338741,2.909090909090909,250.0409981189452,13.891166562163622,0.013229788292590276,1,0
WebHttpHandlerBuilder.java,webHandler,2,3,2,6,5,8,18.575424759098897,2.0,37.150849518197795,2.0639360843443217,0.003711287321761281,2,0
WebHttpHandlerBuilder.java,applicationContext,11,53,80,158,64,238,1428.0,16.39622641509434,23413.811320754718,1300.7672955974842,0.27280991785277503,6,0
VersionRequestCondition.java,updateVersion,15,56,121,201,71,322,1980.2185724805076,26.919642857142858,53306.776750256526,2961.4875972364734,0.47213590339727096,14,0
HandshakeWebSocketService.java,initUpgradeStrategy,16,95,118,194,111,312,2119.857750301233,16.33684210526316,34631.78135228962,1923.9878529049788,0.3541565670268721,19,0
ResourceHttpMessageWriterTests.java,of,2,5,2,8,7,10,28.07354922057604,1.6,44.91767875292167,2.495426597384537,0.00421201861424495,1,0
BeanDefinitionBuilder.java,genericBeanDefinition,4,5,6,9,9,15,47.548875021634686,3.6,171.17595007788486,9.509775004326936,0.01027638997097381,2,0
BeanDefinitionBuilder.java,genericBeanDefinition,4,8,8,15,12,23,82.45413751658658,3.75,309.2030156871997,17.17794531595554,0.015241974332396123,3,0
BeanDefinitionBuilder.java,genericBeanDefinition,4,8,8,15,12,23,82.45413751658658,3.75,309.2030156871997,17.17794531595554,0.015241974332396123,2,0
BeanDefinitionBuilder.java,rootBeanDefinition,1,5,1,7,6,8,20.67970000576925,0.7,14.475790004038473,0.8042105557799152,0.00197988634999937,2,0
BeanDefinitionBuilder.java,rootBeanDefinition,4,11,10,21,15,31,121.11360846386408,3.8181818181818183,462.43377777111743,25.690765431728746,0.01993326518893554,3,0
BeanDefinitionBuilder.java,rootBeanDefinition,1,5,1,7,6,8,20.67970000576925,0.7,14.475790004038473,0.8042105557799152,0.00197988634999937,3,0
BeanDefinitionBuilder.java,rootBeanDefinition,4,10,10,21,14,31,118.02800258378574,4.2,495.71761085190013,27.539867269550008,0.020878612975277645,1,0
BeanDefinitionBuilder.java,childBeanDefinition,5,63,93,240,68,333,2027.125126136363,9.523809523809524,19305.953582251077,1072.5529767917265,0.23988674434272345,9,0
PathExtensionContentNegotiationStrategy.java,initFileTypeMap,9,18,22,34,27,56,266.2737001211542,8.5,2263.326451029811,125.74035839054505,0.05746148929703841,7,0
PathExtensionContentNegotiationStrategy.java,getMediaType,4,11,6,16,15,22,85.95159310338741,2.909090909090909,250.0409981189452,13.891166562163622,0.013229788292590276,1,0
ReactorClientHttpRequest.java,convertException,9,33,30,75,42,105,566.1933293917699,10.227272727272728,5790.613596052193,321.700755336233,0.10748845051494223,4,0
SimpleBufferingClientHttpRequest.java,addHeaders,8,25,23,52,33,75,378.329558951884,8.32,3147.701930479675,174.87232947109305,0.07159364581729448,5,0
BodyInsertors.java,sseMessageWriter,8,52,75,117,60,192,1134.1229943568355,9.0,10207.10694921152,567.0614971784178,0.15684855504353754,1,0
