Archivo,η1,η2,N1,N2,η,N,V,D,E,T,B,CC,refactor
SpelReproTests.java,23,218,437,813,241,1250,9573.377157279598,32.813793103448276,260367.8634495614,14464.881302753412,1.37196930660374,18,0
CacheNamespaceHandler.java,7,28,17,40,35,57,238.13244293319676,5.0701754385964914,621.3530563110592,34.51961423950329,0.029904353751585313,3,0
AbstractSockJsIntegrationTests.java,13,116,131,284,129,415,2909.65931100065,15.913793103448274,46303.7162767862,2572.428682043678,0.4298226632912761,15,0
SpringRunnerContextCacheTests.java,3,20,14,45,23,59,227.65148445440323,3.2857142857142856,589.2543136557731,32.736350758654055,0.024696643523308,2,0
MetaAnnotationUtils.java,27,79,159,256,106,415,2292.6137999400808,38.77443724946038,40076.840899239854,2226.4911610688805,0.48642665808218905,21,0
WebTestClient.java,18,154,194,365,172,559,3850.820539588766,15.506716417910447,33323.483791476574,1851.3046550820318,0.3701948035739639,33,0
TestAnnotationUtils.java,6,23,18,31,29,49,189.04878301959548,4.045454545454545,382.25104413598103,21.236169118665615,0.022118941833767863,5,0
RSocketRequester.java,6,48,48,119,54,167,961.0662128612992,7.4375,7147.929958155913,397.1072198975507,0.12368933960813214,21,0
SharedEntityManagerCreator.java,36,153,347,496,189,843,5658.323543793838,48.337784679089026,182848.24739200508,10158.235966222504,1.1367862873137495,60,0
MimeTypeUtils.java,36,128,236,352,164,588,3409.0416981006274,46.45161787365177,65971.66435929519,3665.092464405288,0.6880295107482872,41,0
GenericCollectionTypeResolver.java,3,6,7,15,9,22,69.73835003173087,3.75,261.51881261899075,14.528822923277264,0.013631616800472117,2,0
DefaultConversionTests.java,11,29,35,74,40,109,481.042112555529,12.6,2873.0358303109624,159.61310168394235,0.08348774269359577,2,0
Response.java,32,111,104,213,143,317,1655.7028899870502,24.62025406287701,8822.420847428535,490.1344915238075,0.19601007582872948,11,0
ShallowEtagHeaderFilter.java,7,29,19,56,36,75,337.59701265360627,7.196428571428572,1992.2978634064934,110.68321463369408,0.05511276507167865,3,0
TestPropertySourceUtils.java,58,228,295,494,286,789,4434.9599572563,63.14912868139612,61481.08591714229,3415.615884285683,0.7998021785111602,61,0
BeanNamePointcutMatchingTests.java,4,11,7,19,15,26,101.57915548582149,3.4545454545454546,350.9098098601106,19.49498943667281,0.016583483060234536,1,0
UriComponentsBuilder.java,31,165,378,726,196,1104,7363.711600493711,55.64583333333333,216326.54546932149,12018.141414962305,1.3535184291293962,53,0
HandlerMethodValidator.java,9,43,31,72,52,103,587.1452909685324,7.534883720930233,4424.07149473964,245.78174970775777,0.08983112455067215,7,0
MockServerHttpRequest.java,21,131,188,406,152,594,3636.4683618566096,26.4328165374677,51507.22019522326,2861.512233067959,0.5200035909538788,6,0
MethodValidationInterceptor.java,11,31,57,73,42,130,701.0012649612389,12.951612903225808,9079.097028449596,504.3942793583109,0.14506874375880158,9,0
TestPropertySourceUtilsTests.java,7,58,61,146,65,207,1246.63013729689,8.810344827586206,10983.241382046737,610.1800767803743,0.1647020851764003,1,0
TestBeanCreator.java,8,13,10,25,21,35,119.2481250360578,7.75,459.0676876406254,25.50376042447919,0.024910124438053183,2,0
TestContextAotGeneratorTests.java,23,207,356,550,230,906,5608.489379055043,24.3068144499179,46942.3833960827,2607.9101886712606,0.5723201903614372,9,0
ScenariosForSpringSecurityExpressionTests.java,6,21,12,24,27,36,171.17595007788486,3.4285714285714284,586.8889716956052,32.60494287197807,0.023365910620090014,2,0
HintUtils.java,2,8,3,13,10,16,53.150849518197795,1.625,86.37013046707142,4.798340581503968,0.006513100741703149,3,0
TypeDescriptor.java,51,94,85,167,145,252,1008.3689351268724,44.86923076923077,5566.806328838854,309.2670182688252,0.20549817156748856,43,0
JdbcTestUtils.java,30,100,87,214,130,301,1409.1350852404366,29.48211437685122,9529.867420014296,529.4370788896831,0.22817867672413453,27,0
Jackson2ObjectMapperBuilderTests.java,15,245,506,933,260,1439,11418.233370057567,26.405462184873947,287613.28419450653,15978.515788583694,1.4561496769473674,4,0
RequestPredicates.java,85,318,439,863,403,1302,7915.742079602841,89.0735994397759,197684.81793962512,10982.48988553473,1.4397423002691125,53,0
ExtendedBeanInfoTests.java,0,3,0,3,3,3,4.754887502163468,0.0,0.0,0.0,0,1,0
Jaxb2XmlDecoderTests.java,14,113,204,362,127,566,3638.405741594645,23.580524344569287,77430.58061502366,4301.69892305687,0.6145456538713842,5,0
SpelDocumentationTests.java,3,6,4,8,9,12,38.039100017307746,2.0,76.07820003461549,4.22656666858975,0.0059848356844364944,1,0
CachedIntrospectionResults.java,32,130,229,395,162,624,3798.8763946350555,46.40128418329638,87349.47167996338,4852.748426664632,0.797080315811932,51,0
ParameterizedDependencyInjectionTests.java,5,29,17,41,34,58,261.0474461086494,3.5166666666666666,713.4804128035287,39.63780071130715,0.02809247980163782,2,0
RSocketServerToClientIntegrationTests.java,15,133,202,327,148,529,3475.353124959031,17.840350877192982,49161.85542633018,2731.2141903516763,0.46571796603496274,4,0
AnnotationUtils.java,176,606,1071,1912,782,2983,17430.654714313077,257.4318191055598,453838.08471531817,25213.226928628792,3.92793359712144,293,0
StompBrokerRelayMessageHandlerIntegrationTests.java,38,166,243,475,204,718,4484.563310124414,45.95605413105413,104644.6083056443,5813.589350313572,0.8547094754263191,11,0
DefaultRequestPath.java,21,57,118,162,78,280,1476.1225817768238,29.87777777777778,22652.73844520508,1258.48546917806,0.3321791579638814,8,0
DomUtils.java,37,91,79,166,128,245,1103.9562801293139,33.813095238095244,8456.373612817448,469.7985340454138,0.2192961457145074,16,0
HttpStatusCode.java,10,10,16,18,20,34,146.94555522617034,9.0,1322.5099970355332,73.47277761308517,0.04016163526339613,2,0
ContentDispositionTests.java,7,31,68,129,38,197,1033.8417201483862,14.564516129032258,15057.404407967626,836.5224671093125,0.20325698931685118,1,0
HttpServerErrorException.java,6,43,51,338,49,389,1954.2310280879037,28.12807881773399,51382.33193949272,2854.573996638484,0.46538203500077063,13,0
FormTagTests.java,2,10,2,12,12,14,36.18947501009619,1.2,21.713685006057712,1.206315833669873,0.003268720344388722,2,0
HttpStatus.java,13,24,23,44,37,67,283.6926969111504,11.822222222222221,1655.8791027024422,91.99328348346901,0.05854770554056672,8,0
DefaultRSocketRequesterBuilder.java,17,100,138,221,117,359,2371.2301757658674,18.382488479262673,39788.588764479915,2210.4771535822174,0.39326897725792687,8,0
PathMatchingUrlHandlerMappingTests.java,7,51,245,600,58,845,4949.993940882799,41.1764705882353,203823.27991870348,11323.515551039083,1.1544663247198617,5,0
MockHttpServletRequestBuilder.java,3,17,12,42,20,54,233.38411712391758,3.7058823529411766,864.8940811062828,48.049671172571266,0.03025896218661758,2,0
SerializableTypeWrapper.java,28,123,253,474,151,727,4856.097348610474,46.697224344283164,174329.9160135937,9684.995334088537,1.0838256722212636,32,0
ControllerAdviceBean.java,2,14,11,19,16,30,120.0,1.3571428571428572,162.85714285714286,9.047619047619047,0.009940692035811561,1,0
EndpointHandshakeHandler.java,11,36,25,48,47,73,405.48498617246753,7.333333333333333,2973.556565264762,165.19758695915345,0.06892808532319919,3,0
ConcreteTransactionalJUnit38SpringContextTests.java,18,92,60,200,110,260,1518.6638163590158,16.604761904761904,15853.353501887546,880.7418612159747,0.22377460162350557,6,0
AnnotationConfigUtils.java,48,160,204,369,208,573,2919.0145121474916,52.84459501850806,35597.91130256116,1977.6617390311756,0.5411144033089992,35,0
BeanWrapperAutoGrowingTests.java,5,42,55,135,47,190,1055.371881818751,8.035714285714286,8480.666907472107,471.14816152622814,0.13862197513705285,1,0
AotIntegrationTests.java,20,63,60,91,83,151,792.3271202604114,14.472727272727273,5176.676281486856,287.59312674926974,0.121580980081447,6,0
DefaultServerWebExchange.java,15,147,237,478,162,715,5247.992752062506,24.387755102040817,127986.7620145856,7110.375667476978,0.8465555211769096,35,0
HandlerMappingIntrospector.java,14,81,114,262,95,376,2470.2657087324365,22.641975308641975,55931.6951829048,3107.3163990502667,0.4875106041200613,11,0
ContextLoaderUtils.java,7,16,15,30,23,45,203.5602880225656,6.5625,1335.8643901480868,74.21468834156038,0.04043154408038351,4,0
BodyExtractors.java,19,85,128,202,104,330,1959.9963086663033,19.4,23000.212523793416,1277.7895846551896,0.30652300717847797,4,0
BodyPopulators.java,8,49,77,113,57,190,1108.2491026913008,9.224489795918368,10223.032539111591,567.9462521728661,0.15701166078733597,1,0
RequestContextHolderTests.java,2,24,7,46,26,53,249.12330506147785,1.9166666666666667,477.4863347011659,26.527018594509215,0.020363513360818642,1,0
ConfigurationClassMethodVisitor.java,5,25,18,38,30,56,274.78587335407707,3.8,1044.1863187454928,58.01035104141627,0.034308158756206276,1,0
RestClient.java,17,146,173,403,163,576,3969.875513433121,17.284615384615385,45836.95216476903,2546.4973424871678,0.44095113214207926,73,0
DefaultResponses.java,17,95,133,219,112,352,2058.6885993159003,19.379919499105547,22746.576381898845,1263.698687883269,0.31865806674770336,3,0
DefaultServerRequestObservationConvention.java,3,14,9,18,17,27,110.36149671375915,1.9285714285714288,212.84002937653554,11.824446076474196,0.011882676816786375,3,0
MockClientHttpResponse.java,6,20,17,39,26,56,263.22462421590114,5.85,1539.8640516630217,85.54800287016786,0.04444951216179343,2,0
DispatcherApp.java,8,76,79,177,84,256,1636.4332602313627,9.31578947368421,15244.667740050063,846.9259855583368,0.2049387364042207,1,0
HttpHeaders.java,2,4,2,7,6,9,23.264662506490403,1.75,40.71315938635821,2.2618421881310113,0.003944893492189711,1,0
SockJsFrame.java,16,52,56,120,68,176,855.303389209219,16.926470588235293,8687.92312848738,482.6623960270767,0.15433745064495064,9,0
ViewResolutionResultHandler.java,17,222,448,790,239,1238,9781.273108280167,30.24774774774775,295861.4816310871,16436.74897950484,1.4800317445380973,34,0
CachedExpressionEvaluatorTests.java,3,4,3,7,7,10,28.07354922057604,2.625,73.69306670401211,4.0940592613340065,0.005859085449651798,1,0
HttpRange.java,37,114,197,342,151,539,2987.4894837424345,54.88787878787879,71269.56287877719,3959.420159932066,0.7240845643668856,29,0
SpelCompilationCoverageTests.java,106,782,4898,11750,888,16648,133767.20753359838,300.7551253236348,22887507.33200376,1271528.1851113206,28.61908320667973,122,0
ExchangeStrategies.java,11,21,14,31,32,45,164.09775004326937,8.653846153846153,570.8889145696935,31.71605080942742,0.029668499978084056,6,0
ControllerMethodResolver.java,7,17,28,46,24,74,339.28722505336555,9.470588235294118,3213.2496019759915,178.51386677644396,0.07258413744119904,1,0
ReflectionUtils.java,117,283,408,675,400,1083,5434.258569138412,123.6094903438187,95003.12831762675,5277.951573201486,1.1512131860031005,101,0
MessageHeaders.java,16,76,121,203,92,324,2113.6340737624723,21.36842105263158,45165.02283934546,2509.1679355191923,0.42274670836870587,7,0
VersionRequestConditionTests.java,9,71,92,229,80,321,2029.3389184588434,14.514084507042254,29453.996555941383,1636.3331419967435,0.3179129603009018,4,0
CommonAnnotationBeanPostProcessorTests.java,1,3,1,3,4,4,8.0,0.5,4.0,0.2222222222222222,0.0008399473665965822,1,0
UndertowServerHttpRequest.java,18,100,122,228,118,350,2217.5977168248746,18.913690476190474,27966.300464827516,1553.6833591570842,0.33351169230916694,10,0
OptionTagTests.java,8,33,27,79,41,106,567.9005124895169,9.575757575757576,5438.077634748101,302.1154241526723,0.10308030166434692,2,0
MissingFieldException.java,7,11,19,19,18,38,158.45715005480787,6.045454545454546,957.9454980586113,53.21919433658952,0.0323921130240093,2,0
AbstractPropertyAccessorTests.java,9,38,52,112,47,164,910.9525716751326,13.26315789473684,12082.107792743864,671.2282107079924,0.17551216199353864,2,0
ServerResponse.java,36,130,98,222,166,320,1580.4692631731414,26.781967213114754,6805.924947683238,378.1069415379577,0.18319381356793946,13,0
ScheduledExecutorFactoryBeanTests.java,5,11,5,13,16,18,72.0,2.9545454545454546,212.72727272727272,11.818181818181818,0.011878479707948477,2,0
ApiVersionInserter.java,11,43,11,59,54,70,271.07967323299613,7.151315789473684,460.79690359064745,25.599827977258194,0.030924738609168265,6,0
CompositeLog.java,5,35,51,158,40,209,1112.2829718314588,11.285714285714285,12552.907824955033,697.3837680530573,0.1800424739204899,1,0
PathPatternTests.java,8,69,94,223,77,317,1986.5713334002837,12.927536231884059,25681.472889754394,1426.748493875244,0.2901518632955224,6,0
AbstractExpressionTests.java,11,37,103,163,48,266,1411.8975950826896,25.075,33925.41198250397,1884.7451101391096,0.3512048373350946,20,0
AbstractCacheOperationTests.java,5,10,6,13,15,19,74.23092131656186,3.25,241.25049427882604,13.402805237712558,0.012917869310319184,1,0
XmlBeanFactoryTests.java,32,529,1938,4035,561,5973,52685.40588428439,83.16442577030811,3421631.500697477,190090.6389276376,7.678324547749381,29,0
RestTemplate.java,17,195,931,1856,212,2787,21537.714306867634,80.9025641025641,1742456.3123340707,96803.12846300393,4.826733759607112,42,0
OrderUtils.java,16,33,27,50,49,77,320.1164292784314,12.428205128205127,1527.8040241102915,84.87800133946064,0.0591388164531406,12,0
AbstractHttpHandlerIntegrationTestCase.java,7,20,28,39,27,67,318.5774626449524,6.825,2174.2911825518,120.7939545862111,0.0559444765973185,4,0
ConversionException.java,6,13,19,19,19,38,161.42124551085624,4.384615384615384,707.7700764706773,39.320559803926514,0.026473226586864736,1,0
ResourceUrlProvider.java,12,94,143,220,106,363,2442.235125006441,14.042553191489361,34295.21664902662,1905.289813834812,0.35185828300104127,19,0
SimpleNamingContextBuilder.java,15,59,102,146,74,248,1539.9444346759797,18.559322033898304,28580.324677460976,1587.7958154144987,0.3115947875417372,19,0
DefaultListableBeanFactoryTests.java,19,77,70,190,96,260,1448.1504758418303,24.0,21209.152001336835,1178.286222296491,0.2935028624723452,6,0
NativeMessageHeaderAccessor.java,6,12,21,33,18,54,225.17595007788486,8.25,1857.70158814255,103.20564378569722,0.05037279476146874,3,0
MessageHeaderAccessor.java,11,45,58,101,56,159,923.369432607159,12.344444444444445,11398.482662517263,633.2490368065146,0.16882759762348434,7,0
HttpClientErrorException.java,6,55,105,680,61,785,4302.046036935337,40.958188153310104,169887.9253541895,9438.21807523275,1.0272714745181737,25,0
EvaluationTests.java,3,4,5,5,7,10,28.07354922057604,1.875,52.63790478858007,2.924328043810004,0.004681781502311053,1,0
HttpComponentsClientHttpResponse.java,7,25,22,40,32,62,310.0,5.6000000000000005,1736.0000000000002,96.44444444444446,0.04814803407088173,5,0
FreeMarkerViewTests.java,4,16,10,24,20,34,146.94555522617034,3.0,440.83666567851105,24.49092587102839,0.01930770040049198,1,0
BeanFactoryUtils.java,29,88,248,453,117,701,4063.3225890301796,56.96233766233767,165027.0474724787,9168.169304026595,1.0512067468656798,72,0
ProxyFactoryBeanTests.java,9,56,53,91,65,144,867.2209650760974,7.3125,6341.553307118962,352.3085170621646,0.11420256113206699,2,0
Literal.java,11,31,44,72,42,116,625.5088210423362,12.774193548387098,7990.370746218231,443.90948590101283,0.13322632014960856,7,0
HttpStatusCodeException.java,5,11,10,19,16,29,116.0,4.318181818181818,500.90909090909093,27.82828282828283,0.02102412940862831,2,0
AbstractAspectJAdvisorFactoryTests.java,16,186,207,522,202,729,5582.836170926058,22.451612903225808,125343.67661175925,6963.53758954218,0.8348600858625488,13,0
RequestMappingHandlerAdapterTests.java,9,170,368,709,179,1077,8060.069592113604,18.76764705882353,151268.54137434385,8403.807854130215,0.9463341038189117,3,0
InvocableHandlerMethod.java,20,62,63,109,82,172,922.5715535740476,17.817708333333336,8557.04541478581,475.39141193254505,0.17159442498844346,14,0
DefaultWebClient.java,9,41,45,89,50,134,756.276729429813,9.76829268292683,7387.532442357077,410.41846901983763,0.12643821208376127,3,0
ConditionalTestCase.java,5,22,19,35,27,54,256.7639251168273,3.977272727272727,1021.220156714654,56.73445315081411,0.03380324014894276,4,0
PropertySourcesPlaceholderConfigurerTests.java,7,14,7,20,21,27,90.80615605397529,6.15,260.98015748905925,14.498897638281068,0.016917011780421435,2,0
MethodValidationTests.java,24,219,400,921,243,1321,9011.13579816102,48.5625,247107.64986448394,13728.202770249107,1.5459949834727649,6,0
InternalConfigurationPostProcessor.java,5,10,7,13,15,20,78.13781191217038,3.25,253.94788871455373,14.10821603969743,0.01336724217607629,1,0
RSocketClientToServerIntegrationTests.java,16,129,277,419,145,696,4610.789298638903,24.333333333333336,91501.45193039284,5083.413996132936,0.7064758711132137,3,0
CommonAnnotationBeanRegistrationAotContributionTests.java,7,54,62,94,61,156,925.1950246598103,6.092592592592593,5636.8363539458815,313.15757521921563,0.10557693012067099,1,0
HandlerStrategies.java,11,28,18,42,39,60,246.55173497486535,8.75,890.917124893846,49.49539582743589,0.0382902004932205,7,0
AnnotatedElementUtilsTests.java,6,126,127,521,132,648,4564.767389344278,12.404761904761905,56624.852615437354,3145.8251453020753,0.49153011925021656,3,0
MergedSqlConfigTests.java,8,74,58,145,82,203,839.7546715677382,5.42,1299.9277565522355,72.2182086973464,0.051115189583922055,9,0
Jackson2JsonEncoder.java,9,30,20,41,39,61,322.4095353505972,6.15,1982.8186424061728,110.15659124478738,0.05260989167776261,1,0
ConcurrentBeanWrapperTests.java,12,50,52,97,62,149,887.1752502476444,11.64,10326.719912882581,573.7066618268101,0.15807153741099828,6,0
SpelUtilities.java,9,25,34,56,34,90,382.333799324893,10.316176470588236,2703.8502845246417,150.2139046958134,0.0716763319605878,5,0
BridgeMethodResolverTests.java,13,311,824,1860,324,2684,22384.157407742332,38.87459807073955,870175.1223781505,48343.062354341695,3.0382011277840073,8,0
ResourceHttpMessageWriter.java,21,124,161,287,145,448,3023.8178716313955,23.928399034593724,47892.594723224225,2660.6997068457904,0.47001495497745965,11,0
ConversionServiceFactory.java,13,21,37,38,34,75,316.71577468408117,12.107142857142858,3015.48779469315,167.52709970517498,0.07268262628769581,8,0
OrderComparator.java,10,21,14,37,31,51,174.63947465869666,8.722222222222221,578.4646557082286,32.13692531712381,0.03148443625790697,16,0
WebClient.java,6,62,45,124,68,169,1028.7812201713073,6.0,6172.687321027844,342.92707339043574,0.11216609422982969,14,0
ResourceUrlProviderTests.java,9,18,13,36,27,49,232.98948760600993,9.0,2096.9053884540895,116.49474380300497,0.05460905179896727,2,0
TestResourceUtils.java,6,8,6,12,14,18,68.53238859703687,4.5,308.3957486866659,17.133097149259218,0.01521543361852368,1,0
ParameterContentTypeResolver.java,10,39,45,74,49,119,668.1504714497098,9.487179487179487,6338.86344708699,352.1590803937217,0.11417026508824527,3,0
DefaultAsyncServerResponse.java,11,28,40,61,39,101,533.8256241050872,11.982142857142856,6396.374888830597,355.35416049058875,0.11485979011978285,5,0
JRubyScriptUtils.java,35,142,158,330,177,488,2970.7362127209794,35.83017955343537,50609.76794204442,2811.6537745580235,0.5348262813007006,29,0
AbstractDelegatingSmartContextLoader.java,9,31,27,64,40,91,435.0,9.146666666666667,3266.8999999999996,181.49444444444444,0.07643135410077066,5,0
DefaultEntityResponseBuilder.java,16,103,171,386,119,557,3840.413494162525,29.980582524271846,115137.83368906677,6396.546316059265,0.7889039210096782,15,0
ControllerMethodResolverTests.java,5,42,11,68,47,79,438.81251928253334,4.0476190476190474,1776.1459113816825,98.67477285453792,0.04888750111992401,1,0
AutowiredAnnotationBeanPostProcessorTests.java,5,30,36,84,35,120,615.513962033396,7.0,4308.597734233772,239.3665407907651,0.08826110853545578,1,0
AnnotationDrivenCacheBeanDefinitionParser.java,32,186,181,402,218,583,3044.113476119521,32.060540439952206,17731.789598771953,985.0994221539972,0.383015323681776,16,0
SimpMessageHeaderAccessor.java,30,93,57,169,123,226,949.1734295819255,25.629082321187582,4117.73473412637,228.7630407847984,0.14835486199332487,17,0
NettyDataBufferFactory.java,4,14,10,18,18,28,116.75790004038474,2.5714285714285716,300.2346001038465,16.67970000576925,0.01494580249624294,2,0
MergedSqlConfig.java,10,61,89,182,71,271,1666.581469385769,14.918032786885247,24862.117002312294,1381.228722350683,0.2839471294547825,7,0
ServletServerHttpRequest.java,22,129,168,323,151,491,3301.426971964047,24.38784403669725,55002.59741129694,3055.6998561831633,0.5190840498109746,18,0
ProfilesTests.java,10,26,32,46,36,78,403.2541501125003,8.846153846153847,3567.2482509951956,198.180458388622,0.0778217455314522,3,0
XStreamMarshallerTests.java,12,34,22,46,46,68,307.60221301187687,8.117647058823529,1248.5030998717355,69.36128332620753,0.048694714867315865,4,0
ExpressionTestCase.java,11,37,103,163,48,266,1411.8975950826896,25.075,33925.41198250397,1884.7451101391096,0.3512048373350946,20,0
MediaType.java,35,110,169,263,145,432,2215.3677109864993,40.396591970121385,29279.530513673177,1626.6405840929544,0.4346683968770043,45,0
PayloadUtils.java,14,38,43,83,52,126,515.5605455547555,14.833333333333334,2687.448830523688,149.30271280687157,0.09067176510633937,12,0
ClassPathBeanDefinitionScanner.java,5,10,10,13,15,23,89.85848369899593,3.25,292.04007202173676,16.224448445652044,0.014672598820854352,2,0
ApplicationContextAotGeneratorTests.java,33,117,73,167,150,240,1046.2451999790676,24.765526695526695,3688.795872375231,204.93310402084614,0.14545820912486412,8,0
DefaultWebFilterChain.java,10,34,52,100,44,152,829.8336060328692,14.705882352941178,12203.435382836313,677.9686323797952,0.17668519055125892,2,0
WebAsyncManager.java,5,13,6,16,18,22,91.73835003173087,3.076923076923077,282.27184625147964,15.681769236193313,0.014343565507099103,2,0
GroupsMetadataValueDelegateTests.java,7,21,16,30,28,46,221.13832641464978,5.0,1105.691632073249,61.42731289295827,0.035642494712041006,2,0
DataBufferUtils.java,49,218,550,1029,267,1579,10632.331546647401,90.62564102564102,490415.3596114311,27245.297756190615,2.4256836532044153,65,0
PubSubHeaders.java,16,68,104,209,84,313,1847.8712150565796,22.096551724137928,33034.023014046295,1835.2235007803497,0.35192005670458715,9,0
ComponentBeanDefinitionParser.java,14,43,30,64,57,94,402.7569537570307,10.474025974025974,1526.7053501477342,84.81696389709634,0.061515446660208695,5,0
AnnotationConfigContextLoaderUtils.java,15,19,24,30,34,54,221.88527353358214,11.795454545454547,1340.9935902449677,74.4996439024982,0.05044635331688187,2,0
ComponentScanAnnotationIntegrationTests.java,4,35,36,63,39,99,523.2548196673627,3.6,1883.7173508025055,104.65096393347253,0.05084199348510454,1,0
ConfigurationClassUtils.java,24,61,50,97,85,147,695.534061798109,19.17357609710551,6500.809690156123,361.15609389756236,0.13796014078427846,15,0
XmlBeanFactoryTestTypes.java,25,135,187,415,160,602,4031.352846607646,32.22865497076023,91641.45836313695,5091.1921312853865,0.7025255553306731,25,0
GenericTypeResolver.java,32,145,263,437,177,700,4159.176683165038,45.82692307692307,70176.17863187972,3898.676590659985,0.7359913950710124,56,0
MockHttpServletRequestBuilderTests.java,4,17,12,46,21,58,254.75441052116813,5.411764705882353,1378.6709275263217,76.59282930701788,0.04129072327588015,1,0
CronField.java,43,149,207,425,192,632,3666.493974247337,52.91635972843501,80232.96968441477,4457.3872046897095,0.7382767746763914,30,0
DerivedTestBean.java,5,23,18,47,28,65,312.4780699337442,5.108695652173914,1596.3553572702153,88.68640873723419,0.04553008502385875,2,0
RestClientAdapterTests.java,6,61,32,130,67,162,982.706448854159,6.39344262295082,6282.8772959528205,349.0487386640456,0.1134970213675033,1,0
ClientCodecConfigurer.java,5,16,12,24,21,36,158.12342722003538,3.75,592.9628520751327,32.942380670840706,0.02352684744014138,7,0
HttpMethod.java,11,33,33,75,44,108,496.1748090499132,11.958333333333332,3539.8742521645827,196.65968067581014,0.08987512751104403,7,0
AbstractEntityManagerFactoryIntegrationTests.java,9,49,62,106,58,168,984.140807181432,9.73469387755102,9580.309490317206,532.2394161287336,0.15035981107534227,7,0
ObjectUtils.java,184,397,609,957,581,1566,6843.573898911033,213.71259179526965,74605.6883429877,4144.760463499319,1.466529957011248,187,0
AggressiveFactoryBeanInstantiationTests.java,2,2,2,2,4,4,8.0,1.0,8.0,0.4444444444444444,0.0013333333333333333,1,0
Configuration.java,13,28,35,53,41,88,388.93183994052663,12.0,2544.8650367370656,141.38139092983698,0.07044036958610086,10,0
GenericBean.java,30,50,36,71,80,107,378.21165498922556,21.276190476190475,1150.4393141219794,63.91329522899885,0.06950722921909282,7,0
ScriptUtils.java,19,72,101,174,91,275,1608.1706614330608,22.916666666666668,26795.447904486693,1488.6359946937052,0.32247994025647253,23,0
RSocketStrategies.java,10,32,35,53,42,88,428.9095644587768,7.722222222222221,2541.2706232990554,141.18170129439196,0.06534425420053736,16,0
ConfigurationClassAndBFPPTests.java,2,2,2,3,4,5,10.0,1.5,15.0,0.8333333333333334,0.002027400665191133,1,0
MethodValidationAdapterTests.java,14,72,36,107,86,143,694.2729711216398,10.27430930699182,2635.8747461408284,146.43748589671267,0.08712989075962096,3,0
DependencyDescriptor.java,8,10,10,13,18,23,95.90827503317318,5.2,498.72303017250056,27.706835009583365,0.020962916014355668,1,0
AsmUtils.java,26,45,62,95,71,157,608.1756448911553,25.543650793650798,3691.8577334737165,205.10320741520653,0.1211356719770517,25,0
DataBufferUtilsTests.java,11,132,272,553,143,825,5906.893852842171,23.041666666666668,136104.6791925717,7561.371066253983,0.881984154473804,2,0
StringDecoder.java,11,26,13,34,37,47,159.4534584667487,7.25,416.4033050222122,23.13351694567845,0.025470756053468147,5,0
StompHeaderAccessor.java,50,208,180,453,258,633,3641.3769629090802,53.31418704034983,44558.59194032722,2475.4773300181787,0.6638935963331904,25,0
MockitoUtils.java,8,32,32,77,40,109,474.208275126471,9.026315789473685,2075.7800610931067,115.3211145051726,0.06810206581807032,5,0
BeanUtils.java,73,197,370,558,270,928,5281.685085346162,101.12535333440506,108724.12607920822,6040.229226622679,1.2401690706371002,86,0
MetadataReaderFactory.java,4,12,4,16,16,20,60.0,2.6666666666666665,80.0,4.444444444444445,0.007797380635234308,3,0
ReactiveTypeDescriptor.java,20,30,29,46,50,75,273.917857368025,15.416666666666668,1048.813412746577,58.26741181925427,0.05455567258728165,7,0
ScenariosForSpringSecurity.java,6,21,12,24,27,36,171.17595007788486,3.4285714285714284,586.8889716956052,32.60494287197807,0.023365910620090014,2,0
JsonObjectDecoderTests.java,4,10,7,16,14,23,87.56916320732489,3.2,280.2213222634397,15.56785123685776,0.014274016593709563,1,0
RSocketMessageHandlerTests.java,12,89,72,148,101,220,1251.4314313172547,10.053571428571429,6766.981742427495,375.9434301348609,0.14554004988844682,4,0
ExceptionHandlerExceptionResolverTests.java,9,203,654,1308,212,1962,15162.179931852996,28.995073891625616,439628.52748220065,24423.80708234448,1.9272408360461657,2,0
TransportType.java,2,9,4,12,11,16,55.35090589819676,1.3333333333333333,73.80120786426234,4.1000671035701295,0.005864816006249215,1,0
FreePortScanner.java,21,34,37,65,55,102,425.1517545953863,20.497435897435896,3503.1855402142296,194.62141890079056,0.10171970282023701,9,0
JdbcTemplate.java,20,97,127,257,117,384,2474.5489764177623,24.93657505285412,45881.14055723506,2548.9522531797256,0.4491695846088684,19,0
BridgeMethodResolver.java,50,115,142,257,165,399,1795.0751219843075,56.09075077399381,15062.242286807654,836.7912381559807,0.37479746207913683,41,0
ExpressionLanguageScenarioTests.java,11,69,112,275,80,387,2446.586172721409,21.920289855072465,53629.87806146567,2979.4376700814264,0.47404177790355984,7,0
FactoryMethodTests.java,4,12,7,19,16,26,104.0,3.1666666666666665,329.3333333333333,18.296296296296294,0.015896537486793382,1,0
StandardJUnit4FeaturesTests.java,6,29,19,43,35,62,318.01554705058794,4.448275862068966,1414.620881707788,78.590048983766,0.04200543194885183,2,0
LocalVariableTableParameterNameDiscoverer.java,23,70,130,203,93,333,1972.7631095021438,29.3,40951.60164406012,2275.088980225563,0.4160327749825322,15,0
ReflectionTestUtilsTests.java,9,122,330,765,131,1095,7161.816543367654,29.049269212635547,182395.6355015743,10133.09086119857,1.0997217777670825,8,0
DefaultMessageCodesResolver.java,5,12,14,23,17,37,151.23612512626255,4.791666666666667,724.6730995633415,40.259616642407856,0.026893056985797546,3,0
ScriptFactoryPostProcessorTests.java,14,34,32,50,48,82,328.50588723038135,10.373426573426574,1171.7656184057923,65.09808991143291,0.05239143710369422,5,0
TransactionAspectUtils.java,4,16,6,22,20,28,93.01398665684614,2.75,127.89423165316344,7.105235091842413,0.010660789837859947,4,0
LogDelegateFactory.java,13,20,23,34,33,57,237.02757575738562,10.428571428571429,1460.9551882584267,81.16417712546814,0.050133193865865545,3,0
RequestResultMatchers.java,1,5,1,6,6,7,18.094737505048094,0.6,10.856842503028856,0.6031579168349365,0.001634360172194361,1,0
BenchmarkTests.java,16,46,33,57,62,90,457.4784455249121,9.776785714285715,2625.9630226398094,145.88683459110052,0.07439177262123309,2,0
AutowireUtils.java,36,128,196,296,164,492,3004.039209327481,36.82791327913279,59103.59890086325,3283.533272270181,0.575585352014598,50,0
ContentDisposition.java,63,162,352,599,225,951,5364.95240513627,105.2311079897546,135682.21287400322,7537.900715222401,1.3337417924086625,40,0
TestCompiler.java,17,120,268,483,137,751,5244.293137347574,32.173913043478265,162892.17605508064,9049.565336393369,0.9965592006707301,15,0
DefaultParts.java,23,110,183,385,133,568,3505.0350286636394,34.57517482517483,83296.81797309166,4627.600998505092,0.6731827248119043,12,0
DefaultPathContainer.java,53,156,236,436,209,672,3461.474131788628,74.54795017784147,46044.92695979401,2558.0514977663333,0.7444584414411087,28,0
ServerCodecConfigurer.java,5,13,9,15,18,24,100.07820003461549,2.884615384615384,288.6871154844677,16.03817308247043,0.014560077256449627,8,0
ForwardedHeaderFilter.java,10,60,67,145,70,212,1299.4079995923328,12.083333333333332,15701.179995074019,872.2877775041121,0.20900993978654772,7,0
PeriodicTriggerTests.java,14,60,45,131,74,176,799.5793735278671,15.845502645502647,5607.9508917791545,311.55282732106417,0.13159955630894193,7,0
HttpServiceProxyFactory.java,15,94,131,265,109,396,2603.629731221573,19.825,44373.25939712116,2465.181077617842,0.42318792248962994,8,0
ServletAnnotationControllerHandlerMethodTests.java,3,11,8,19,14,27,102.79858289555531,2.590909090909091,266.341782956666,14.796765719814779,0.013798703422966413,1,0
TransactionalApplicationListenerAdapterTests.java,5,18,15,28,23,43,194.51316411045156,3.888888888888889,756.440082651756,42.024449036208665,0.02767335201811332,1,0
HttpLogging.java,8,14,8,19,22,27,94.72503367497927,5.458333333333333,306.9907639092895,17.05504243940497,0.017719799695296082,3,0
ExtendedEntityManagerCreator.java,37,196,257,516,233,773,4953.628766924141,44.85143600360992,113253.73458234286,6291.874143463492,0.8820405556511299,50,0
CountingFactory.java,7,19,13,23,26,36,154.0324320520449,4.205882352941177,555.5824617888777,30.865692321604318,0.023056860320251713,3,0
ClassUtils.java,403,810,1181,1623,1213,2804,13656.430060304874,373.89720431964435,162129.63382458442,9007.201879143584,2.8419027646553494,296,0
MvcUriComponentsBuilder.java,141,456,537,953,597,1490,8266.42874031398,130.77576495526762,97656.10686784123,5425.339270435623,1.3919601165393178,113,0
StreamUtils.java,9,31,12,53,40,65,271.8101159410467,7.059523809523809,932.5691440219819,51.80939689011011,0.03802110668295044,4,0
ResponseEntity.java,35,128,175,389,163,564,3168.1878481085273,39.380865800865806,46293.74364138253,2571.874646743474,0.5336958588607932,19,0
MergedAnnotationsTests.java,2,16,6,18,18,24,76.07820003461549,1.125,42.793987519471216,2.377443751081734,0.005138194985486905,2,0
DefaultRestClient.java,42,342,666,1298,384,1964,14218.11116349167,75.95298771309552,433797.0984241383,24099.83880134102,2.5181042043698443,51,0
RSocketMessageHandler.java,9,24,28,43,33,71,358.15198247445016,8.0625,2887.6003587002547,160.42224215001414,0.06759327201265497,2,0
AnnotationAttributes.java,6,7,9,15,13,24,88.81055323538621,6.428571428571429,570.9249850846256,31.718054726923647,0.02294024814850238,3,0
AopNamespaceUtils.java,32,118,66,188,150,254,1008.333759135763,25.389035964035966,2837.525447322875,157.64030262904862,0.13676655909851343,16,0
ResourceHttpMessageConverter.java,12,29,26,47,41,73,319.2572771991062,9.80952380952381,1672.867183550772,92.93706575282066,0.05730627139456217,9,0
RequestMappingInfo.java,22,143,441,809,165,1250,8239.154532353325,53.80953947368421,296778.0137391864,16487.6674299548,1.64494901699541,30,0
ErrorResponse.java,18,36,28,61,54,89,391.8692932402032,13.52391304347826,1836.49704783381,102.027613768545,0.0673841776198837,9,0
DefaultConversionServiceTests.java,22,57,64,109,79,173,772.9395000622767,20.454166666666666,4624.252655617039,256.9029253120578,0.13730850555306112,6,0
DefaultPartHttpMessageReaderTests.java,20,93,62,161,113,223,1200.5766001028314,17.473768261666766,8370.692740608227,465.0384855893459,0.1826556343353048,5,0
ExceptionWebSocketHandlerDecorator.java,7,23,24,67,30,91,446.5270442003752,10.195652173913043,4552.634428912521,252.9241349395845,0.09156312311166873,8,0
BeanDefinitionMethodGenerator.java,20,123,172,324,143,496,3209.1159345390156,25.528935185185187,53100.32661995301,2950.018145552945,0.5256657105894794,18,0
StompHeaders.java,7,11,9,15,18,24,100.07820003461549,4.7727272727272725,477.6459547106648,26.535886372814712,0.02036805135194445,1,0
SimpLogging.java,8,14,8,19,22,27,94.72503367497927,5.458333333333333,306.9907639092895,17.05504243940497,0.017719799695296082,3,0
ApplicationManagedEntityManagerIntegrationTests.java,3,17,9,35,20,44,190.16483617504394,3.0882352941176467,587.273758775871,32.62631993199283,0.02337612256679133,1,0
RoutingFunctions.java,31,73,67,111,104,178,796.1575905441287,23.367364382824068,4361.589867621314,242.3105482011841,0.1375314221119352,6,0
ClassUtilsTests.java,14,51,31,82,65,113,415.4167325666819,10.26841491841492,964.4368304013987,53.57982391118881,0.05128928615552042,6,0
AnnotatedBeanDefinitionReader.java,5,10,10,13,15,23,89.85848369899593,3.25,292.04007202173676,16.224448445652044,0.014672598820854352,2,0
SocketUtils.java,22,73,106,210,95,316,1738.0907508145324,30.714358974358973,36552.283532334375,2030.682418463021,0.39324461129861066,29,0
HttpServiceMethod.java,42,166,274,446,208,720,4119.496805995828,53.95234177947472,57612.36003203051,3200.6866684461393,0.735884868165146,23,0
AnnotatedElementUtils.java,48,239,395,937,287,1332,8791.102044104278,77.5520578455361,365343.12630201696,20296.840350112052,1.91241166453256,85,0
PubSubHeaderAccesssor.java,16,69,107,209,85,316,1872.341322236286,21.784745762711864,32918.48909922347,1828.8049499568594,0.3511185549231432,9,0
MessageHeaderAccessorTests.java,5,6,9,13,11,22,76.10749561002054,5.416666666666666,412.24893455427787,22.90271858634877,0.018463687449969336,1,0
FactoryMethods.java,1,3,1,3,4,4,8.0,0.5,4.0,0.2222222222222222,0.0008399473665965822,1,0
AnnotationAwareOrderComparator.java,10,17,14,31,27,45,142.88757144927206,9.7,500.19174440493174,27.788430244718427,0.028979520184210388,10,0
MethodParameter.java,5,8,10,19,13,29,107.31275182609167,5.9375,637.1694639674193,35.39830355374552,0.02468209662410386,3,0
LocalVariableTableParameterNameDiscovererTests.java,19,65,40,148,84,188,790.6394536261799,23.20695488721805,5805.381494995006,322.5211941663892,0.14881967640452887,8,0
CallbacksSecurityTests.java,13,137,243,478,150,721,5076.1632507623135,21.630769230769232,98643.00146219939,5480.166747899966,0.7189267050429086,20,0
CharBufferDecoder.java,13,30,15,40,43,55,201.9092240839919,8.75,674.5299025369443,37.47388347427468,0.03446490034288159,5,0
MimeType.java,9,37,60,89,46,149,823.010731452495,10.824324324324323,8908.535079641195,494.91861553562194,0.14324614447753986,7,0
DefaultResponseBuilder.java,14,86,141,258,100,399,2650.898619720115,21.0,55668.87101412242,3092.7150563401347,0.4859821907428967,3,0
ETag.java,4,11,13,23,15,36,140.64806144190666,4.181818181818182,588.164620575246,32.67581225418033,0.023399756783727008,5,0
DummyFactory.java,15,58,60,131,73,191,1000.7666565911147,15.252525252525253,7173.332427210909,398.51846817838384,0.15534477616288545,9,0
CacheAdviceParser.java,6,37,50,129,43,179,971.3013910916756,10.45945945945946,10159.287523039959,564.4048623911088,0.15635829032732892,10,0
SessionFactoryUtils.java,103,338,421,820,441,1241,6625.387368145163,110.63524114774116,111912.40044889155,6217.355580493974,1.2733701033175113,163,0
SpringProperties.java,11,32,22,53,43,75,270.1639501680896,10.00189393939394,1109.3374105098756,61.62985613943753,0.045625454762746105,13,0
HttpServiceProxyRegistryFactoryBean.java,12,110,300,430,122,730,5059.438256420907,23.454545454545453,118666.82455969036,6592.6013644272425,0.8049426874326037,3,0
XmlEventDecoderTests.java,9,53,35,75,62,110,498.41152544244653,6.4441391941391934,1580.5280211428005,87.80711228571114,0.05522238509762298,3,0
FactoryMethodComponent.java,6,26,24,51,32,75,375.0,5.884615384615384,2206.730769230769,122.59615384615384,0.05649954872163508,1,0
TestPropertySourceAttributes.java,10,22,27,44,32,71,355.0,10.0,3550.0,197.22222222222223,0.07757068870639545,5,0
JdkClientHttpResponse.java,8,83,97,154,91,251,1633.4564546898728,7.421686746987952,12123.002121553754,673.5001178640974,0.1759079764404008,1,0
Netty4ClientHttpRequest.java,8,27,27,56,35,83,425.7304904064322,8.296296296296296,3531.986290779289,196.22146059884938,0.07730805579560046,4,0
AbstractUrlHandlerMapping.java,5,6,7,11,11,18,62.26976913547135,4.583333333333333,285.403108537577,15.85572825208761,0.014449446498593787,2,0
MergedContextConfiguration.java,11,44,127,201,55,328,1896.2859860360884,25.125,47644.18539915672,2646.89918884204,0.43807857717225407,22,0
JndiPropertySource.java,4,5,4,9,9,13,41.209025018750054,3.6,148.3524900675002,8.241805003750011,0.009341328368971053,1,0
ObjectToObjectConverter.java,44,80,131,176,124,307,1359.3197355023472,48.17040149393091,12016.424841520626,667.579157862257,0.30392399097929773,17,0
ContentNegotiatingViewResolver.java,12,26,23,41,38,64,275.94119525778194,9.575757575757576,1516.6383458149091,84.25768587860605,0.052251333365630814,7,0
WebHttpHandlerBuilder.java,13,56,82,164,69,246,1446.575424759099,18.39622641509434,23450.962170272916,1302.8312316818285,0.2765212051745363,8,0
VersionRequestCondition.java,15,56,121,201,71,322,1980.2185724805076,26.919642857142858,53306.776750256526,2961.4875972364734,0.47213590339727096,14,0
HandshakeWebSocketService.java,16,95,118,194,111,312,2119.857750301233,16.33684210526316,34631.78135228962,1923.9878529049788,0.3541565670268721,19,0
ResourceHttpMessageWriterTests.java,2,5,2,8,7,10,28.07354922057604,1.6,44.91767875292167,2.495426597384537,0.00421201861424495,1,0
BeanDefinitionBuilder.java,27,115,137,335,142,472,2520.0832872503593,30.04199134199134,21082.638532334455,1171.257696240803,0.3254187338427014,25,0
PathExtensionContentNegotiationStrategy.java,13,29,28,50,42,78,352.2252932245416,11.40909090909091,2513.367449148756,139.63152495270867,0.07069127758962869,8,0
ReactorClientHttpRequest.java,9,33,30,75,42,105,566.1933293917699,10.227272727272728,5790.613596052193,321.700755336233,0.10748845051494223,4,0
SimpleBufferingClientHttpRequest.java,8,25,23,52,33,75,378.329558951884,8.32,3147.701930479675,174.87232947109305,0.07159364581729448,5,0
BodyInsertors.java,8,52,75,117,60,192,1134.1229943568355,9.0,10207.10694921152,567.0614971784178,0.15684855504353754,1,0
